Index;Incoming Calls;Answered Calls;Answer Rate;Abandoned Calls;Answer Speed (AVG);Talk Duration (AVG);Waiting Time (AVG);Service Level (20 Seconds);Date
1;217;204;94,01;13;0:00:17;0:02:14;0:02:45;76,28;44927
2;200;182;91;18;0:00:20;0:02:22;0:06:55;72,73;44927
3;216;198;91,67;18;0:00:18;0:02:38;0:03:50;74,3;44927
4;155;145;93,55;10;0:00:15;0:02:29;0:03:12;79,61;44927
5;37;37;100;0;0:00:03;0:02:06;0:00:35;97,3;44927
6;315;304;96,51;11;0:00:18;0:01:35;0:02:37;77,17;44927
7;252;244;96,83;8;0:00:13;0:01:50;0:02:02;82;44927
8;213;205;96,24;8;0:00:10;0:02:10;0:03:22;88,1;44927
9;219;200;91,32;19;0:00:15;0:02:18;0:06:12;79,45;44927
10;371;348;93,8;23;0:00:19;0:01:40;0:03:29;73,63;44927
11;166;164;98,8;2;0:00:12;0:02:10;0:02:46;81,33;44927
12;32;32;100;0;0:00:02;0:02:03;0:00:03;100;44927
13;231;222;96,1;9;0:00:08;0:01:49;0:02:18;86,46;44927
14;205;197;96,1;8;0:00:07;0:01:52;0:02:48;92,61;44927
15;338;313;92,6;25;0:00:13;0:01:51;0:03:40;80,06;44927
16;180;174;96,67;6;0:00:13;0:02:18;0:03:26;83,8;44927
17;226;211;93,36;15;0:00:20;0:02:04;0:04:53;76,23;44927
18;226;212;93,81;14;0:00:10;0:02:03;0:02:45;84,44;44927
19;45;44;97,78;1;0:00:02;0:02:04;0:00:55;97,78;44927
20;218;194;88,99;24;0:00:26;0:02:43;0:06:28;68,98;44927
21;187;174;93,05;13;0:00:15;0:02:16;0:04:39;81,52;44927
22;191;184;96,34;7;0:00:10;0:02:09;0:03:40;85,64;44927
23;188;174;92,55;14;0:00:15;0:02:25;0:03:09;76,88;44927
24;154;148;96,1;6;0:00:10;0:02:27;0:03:36;85,06;44927
25;166;150;90,36;16;0:00:18;0:02:26;0:04:38;76,83;44927
26;58;57;98,28;1;0:00:04;0:02:26;0:00:58;94,83;44927
27;160;153;95,63;7;0:00:10;0:02:23;0:02:45;84,91;44928
28;86;79;91,86;7;0:00:32;0:02:43;0:04:40;61,63;44928
29;180;170;94,44;10;0:00:23;0:02:31;0:05:45;77,53;44928
30;210;192;91,43;18;0:00:26;0:02:16;0:05:35;67,46;44928
31;163;157;96,32;6;0:00:14;0:02:19;0:02:55;81,37;44928
32;143;140;97,9;3;0:00:15;0:02:20;0:04:43;82,52;44928
33;57;55;96,49;2;0:00:06;0:02:03;0:01:50;91,23;44928
34;179;172;96,09;7;0:00:13;0:02:17;0:03:23;82,49;44928
35;194;184;94,85;10;0:00:24;0:02:24;0:03:19;70,1;44928
36;201;196;97,51;5;0:00:15;0:02:16;0:04:53;81,59;44928
37;218;189;86,7;29;0:00:32;0:02:37;0:08:04;57,41;44928
38;194;190;97,94;4;0:00:16;0:02:22;0:02:02;81,77;44928
39;227;219;96,48;8;0:00:15;0:02:44;0:03:55;83,63;44928
40;52;52;100;0;0:00:09;0:02:16;0:00:52;94,23;44928
41;385;370;96,1;15;0:00:20;0:02:11;0:03:10;76,19;44928
42;137;130;94,89;7;0:00:16;0:02:26;0:09:47;75,91;44928
43;254;252;99,21;2;0:00:10;0:02:08;0:01:10;91,34;44928
44;211;206;97,63;5;0:00:11;0:02:24;0:04:37;87,14;44928
45;282;279;98,94;3;0:00:07;0:02:18;0:01:11;93,21;44928
46;262;260;99,24;2;0:00:08;0:02:31;0:01:13;90,8;44928
47;65;63;96,92;2;0:00:12;0:02:22;0:02:10;85,94;44928
48;325;323;99,38;2;0:00:05;0:02:13;0:01:14;96,9;44928
49;235;230;97,87;5;0:00:05;0:02:19;0:00:58;96,14;44928
50;215;212;98,6;3;0:00:05;0:02:14;0:00:58;95,81;44928
51;85;85;100;0;0:00:03;0:02:26;0:00:55;97,65;44928
52;195;195;100;0;0:00:05;0:02:24;0:02:13;97,44;44928
53;188;182;96,81;6;0:00:15;0:02:14;0:01:51;83,61;44929
54;58;58;100;0;0:00:06;0:02:22;0:00:52;94,83;44929
55;251;247;98,41;4;0:00:14;0:02:16;0:01:53;83,53;44929
56;181;178;98,34;3;0:00:12;0:02:24;0:01:57;86,19;44929
57;228;213;93,42;15;0:00:26;0:02:16;0:03:07;63,56;44929
58;165;163;98,79;2;0:00:09;0:02:25;0:02:20;90,24;44929
59;185;179;96,76;6;0:00:17;0:02:17;0:02:33;78,57;44929
60;172;164;95,35;8;0:00:18;0:02:27;0:04:09;77,06;44929
61;57;51;89,47;6;0:00:07;0:01:47;0:03:40;90,57;44929
62;200;192;96;8;0:00:10;0:02:18;0:02:49;86,43;44929
63;202;199;98,51;3;0:00:08;0:02:05;0:01:17;91;44929
64;217;212;97,7;5;0:00:07;0:01:55;0:01:50;94,42;44929
65;225;223;99,11;2;0:00:09;0:02:09;0:01:06;91,93;44929
66;235;231;98,3;4;0:00:08;0:02:19;0:01:06;95,71;44929
67;202;201;99,5;1;0:00:08;0:02:21;0:01:53;94,55;44929
68;43;39;90,7;4;0:00:11;0:02:15;0:01:50;76,19;44929
69;194;187;96,39;7;0:00:10;0:02:27;0:02:30;87,43;44929
70;202;199;98,51;3;0:00:13;0:02:23;0:01:58;86,07;44929
71;146;140;95,89;6;0:00:12;0:02:13;0:04:35;83,45;44929
72;147;145;98,64;2;0:00:09;0:02:15;0:00:58;91,16;44929
73;155;145;93,55;10;0:00:12;0:02:33;0:04:33;82,24;44929
74;157;156;99,36;1;0:00:09;0:02:24;0:00:53;92,95;44929
75;38;36;94,74;2;0:00:13;0:02:11;0:00:59;83,78;44929
76;166;162;97,59;4;0:00:09;0:02:29;0:02:45;89,09;44929
77;226;216;95,58;10;0:00:13;0:02:15;0:01:46;81,45;44929
78;253;247;97,63;6;0:00:10;0:01:54;0:01:17;88,49;44929
79;134;134;100;0;0:00:03;0:02:13;0:00:26;100;44930
80;70;67;95,71;3;0:00:12;0:02:01;0:01:16;83,82;44930
81;83;82;98,8;1;0:00:07;0:02:03;0:01:16;95,18;44930
82;42;40;95,24;2;0:00:08;0:01:51;0:01:36;90,24;44930
83;66;64;96,97;2;0:00:05;0:02:00;0:01:39;95,45;44930
84;153;146;95,42;7;0:00:20;0:02:08;0:04:32;76;44930
85;141;135;95,74;6;0:00:23;0:02:06;0:02:15;66,91;44930
86;146;143;97,95;3;0:00:17;0:01:57;0:02:27;78,32;44930
87;144;140;97,22;4;0:00:12;0:01:53;0:02:05;84,03;44930
88;105;103;98,1;2;0:00:17;0:01:55;0:02:01;76,19;44930
89;36;35;97,22;1;0:00:16;0:01:54;0:01:31;77,14;44930
90;61;57;93,44;4;0:00:04;0:02:00;0:03:41;91,67;44930
91;60;58;96,67;2;0:00:11;0:02:08;0:01:34;85;44930
92;18;17;94,44;1;0:00:05;0:02:39;0:00:20;100;44930
93;206;202;98,06;4;0:00:09;0:01:54;0:01:10;89,27;44930
94;194;193;99,48;1;0:00:11;0:01:57;0:01:34;84,97;44930
95;206;200;97,09;6;0:00:10;0:02:08;0:02:00;86,27;44930
96;53;53;100;0;0:00:18;0:02:08;0:02:10;77,36;44930
97;147;145;98,64;2;0:00:09;0:01:50;0:01:24;88,36;44930
98;201;197;98,01;4;0:00:09;0:01:59;0:02:23;90,95;44930
99;202;198;98,02;4;0:00:10;0:02:09;0:01:11;88,5;44930
100;226;219;96,9;7;0:00:10;0:02:12;0:02:45;88;44930
101;167;163;97,6;4;0:00:07;0:02:09;0:01:50;92,77;44930
102;164;164;100;0;0:00:11;0:02:17;0:01:45;89,02;44930
103;42;41;97,62;1;0:00:11;0:02:09;0:01:18;87,8;44930
104;79;78;98,73;1;0:00:07;0:02:23;0:00:48;94,87;44930
105;165;162;98,18;3;0:00:09;0:02:09;0:01:50;89,7;44931
106;180;174;96,67;6;0:00:16;0:02:16;0:01:43;77,78;44931
107;179;176;98,32;3;0:00:10;0:02:26;0:01:50;87,64;44931
108;217;215;99,08;2;0:00:08;0:02:08;0:02:07;91,71;44931
109;171;167;97,66;4;0:00:10;0:02:15;0:01:50;86,47;44931
110;37;37;100;0;0:00:09;0:01:57;0:01:22;86,49;44931
111;215;206;95,81;9;0:00:18;0:02:09;0:02:45;80,95;44931
112;218;212;97,25;6;0:00:16;0:02:17;0:02:09;84,26;44931
113;205;202;98,54;3;0:00:11;0:02:25;0:01:37;90,69;44931
114;195;190;97,44;5;0:00:12;0:02:22;0:01:14;89,01;44931
115;181;176;97,24;5;0:00:13;0:02:13;0:01:16;82,22;44931
116;212;206;97,17;6;0:00:11;0:02:20;0:01:49;89,42;44931
117;33;32;96,97;1;0:00:08;0:02:28;0:00:55;90,91;44931
118;298;287;96,31;11;0:00:13;0:01:35;0:02:51;83,33;44931
119;158;156;98,73;2;0:00:11;0:02:23;0:01:32;89,81;44931
120;156;154;98,72;2;0:00:12;0:02:13;0:01:01;85,81;44931
121;163;163;100;0;0:00:10;0:02:02;0:02:46;92,64;44931
122;98;98;100;0;0:00:07;0:02:10;0:01:10;93,88;44931
123;255;249;97,65;6;0:00:15;0:02:19;0:05:31;82,68;44931
124;50;49;98;1;0:00:08;0:02:02;0:00:57;92;44931
125;290;289;99,66;1;0:00:12;0:02:01;0:01:10;89,27;44931
126;296;281;94,93;15;0:00:22;0:02:08;0:04:30;73,54;44931
127;260;257;98,85;3;0:00:17;0:02:13;0:01:20;87,16;44931
128;201;193;96,02;8;0:00:19;0:02:23;0:02:02;76,77;44931
129;132;131;99,24;1;0:00:17;0:02:13;0:01:30;76,52;44931
130;167;165;98,8;2;0:00:09;0:02:06;0:00:57;92,12;44931
131;85;79;92,94;6;0:00:18;0:02:25;0:01:53;77,38;44932
132;244;236;96,72;8;0:00:21;0:02:29;0:01:56;75,62;44932
133;186;182;97,85;4;0:00:14;0:02:13;0:01:38;79,03;44932
134;278;264;94,96;14;0:00:19;0:02:20;0:02:10;76,84;44932
135;272;268;98,53;4;0:00:15;0:02:30;0:01:45;80;44932
136;218;206;94,5;12;0:00:25;0:02:21;0:03:41;67,28;44932
137;152;148;97,37;4;0:00:14;0:02:18;0:01:25;83,33;44932
138;48;43;89,58;5;0:00:22;0:02:01;0:01:21;69,57;44932
139;186;181;97,31;5;0:00:14;0:02:20;0:01:49;84,95;44932
140;182;180;98,9;2;0:00:08;0:02:10;0:00:58;93,37;44932
141;192;188;97,92;4;0:00:20;0:01:58;0:01:56;76,19;44932
142;155;148;95,48;7;0:00:14;0:02:24;0:02:18;85,33;44932
143;144;142;98,61;2;0:00:11;0:02:19;0:01:05;90,21;44932
144;164;162;98,78;2;0:00:12;0:02:35;0:01:50;85,37;44932
145;27;26;96,3;1;0:00:11;0:02:04;0:01:17;81,48;44932
146;177;175;98,87;2;0:00:11;0:02:19;0:01:35;90,86;44932
147;134;131;97,76;3;0:00:14;0:02:23;0:01:39;81,34;44932
148;125;120;96;5;0:00:14;0:02:20;0:02:52;84,55;44932
149;167;163;97,6;4;0:00:16;0:02:24;0:01:12;81,21;44932
150;169;167;98,82;2;0:00:09;0:02:14;0:01:44;89,94;44932
151;162;160;98,77;2;0:00:16;0:02:15;0:01:31;83,13;44932
152;25;25;100;0;0:00:16;0:02:35;0:00:58;76;44932
153;157;146;92,99;11;0:00:17;0:02:17;0:01:51;79,74;44932
154;166;154;92,77;12;0:00:25;0:02:18;0:03:39;66,26;44932
155;58;55;94,83;3;0:00:16;0:02:11;0:02:45;74,14;44932
156;75;74;98,67;1;0:00:15;0:02:13;0:03:18;84;44932
157;28;28;100;0;0:00:07;0:02:28;0:00:51;96,43;44933
158;108;107;99,07;1;0:00:09;0:02:11;0:00:59;94,44;44933
159;21;21;100;0;0:00:07;0:02:58;0:00:58;95,24;44933
160;189;182;96,3;7;0:00:21;0:02:10;0:04:46;76,34;44933
161;161;155;96,27;6;0:00:19;0:02:27;0:01:50;71,88;44933
162;155;151;97,42;4;0:00:17;0:02:20;0:01:49;80,52;44933
163;161;150;93,17;11;0:00:17;0:02:22;0:02:45;75,32;44933
164;132;129;97,73;3;0:00:27;0:02:22;0:02:34;65,15;44933
165;122;119;97,54;3;0:00:16;0:02:24;0:01:50;80;44933
166;17;17;100;0;0:00:21;0:02:40;0:00:58;76,47;44933
167;45;45;100;0;0:00:06;0:02:06;0:00:57;95,56;44933
168;177;172;97,18;5;0:00:20;0:02:23;0:02:51;76;44933
169;133;132;99,25;1;0:00:10;0:02:25;0:00:59;93,23;44933
170;177;167;94,35;10;0:00:15;0:02:22;0:04:35;83,24;44933
171;127;124;97,64;3;0:00:16;0:02:22;0:01:45;81,89;44933
172;148;147;99,32;1;0:00:16;0:02:11;0:03:11;83,11;44933
173;23;23;100;0;0:00:32;0:02:02;0:02:43;65,22;44933
174;141;134;95,04;7;0:00:24;0:02:38;0:02:29;72,14;44933
175;124;120;96,77;4;0:00:20;0:02:33;0:02:58;82,26;44933
176;165;156;94,55;9;0:00:25;0:02:21;0:02:38;70,55;44933
177;168;166;98,81;2;0:00:21;0:02:33;0:03:43;80,12;44933
178;198;188;94,95;10;0:00:22;0:02:32;0:02:45;70,92;44933
179;139;133;95,68;6;0:00:17;0:02:40;0:03:03;80,15;44933
180;46;45;97,83;1;0:00:10;0:02:14;0:01:16;88,89;44933
181;184;174;94,57;10;0:00:23;0:02:37;0:04:35;76,54;44933
182;207;190;91,79;17;0:00:21;0:02:23;0:04:06;71,36;44933
183;191;180;94,24;11;0:00:21;0:02:32;0:01:53;76,5;44934
184;213;204;95,77;9;0:00:24;0:02:26;0:02:46;69,67;44934
185;483;451;93,37;32;0:00:16;0:00:57;0:08:45;79,2;44934
186;547;526;96,16;21;0:00:19;0:01:21;0:03:54;81,58;44934
187;54;53;98,15;1;0:00:25;0:02:36;0:01:18;70,37;44934
188;275;261;94,91;14;0:00:22;0:02:13;0:02:12;74,44;44934
189;205;195;95,12;10;0:00:24;0:02:34;0:03:00;70,79;44934
190;80;77;96,25;3;0:00:10;0:02:11;0:01:33;89,61;44934
191;200;195;97,5;5;0:00:21;0:02:30;0:02:48;75,25;44934
192;154;150;97,4;4;0:00:21;0:02:29;0:02:45;74,34;44934
193;163;155;95,09;8;0:00:23;0:02:18;0:02:26;74,52;44934
194;12;12;100;0;0:00:25;0:03:37;0:01:28;66,67;44934
195;218;212;97,25;6;0:00:20;0:01:56;0:04:11;75,93;44934
196;172;163;94,77;9;0:00:18;0:02:09;0:01:53;81,93;44934
197;205;194;94,63;11;0:00:18;0:02:24;0:01:41;80,6;44934
198;178;168;94,38;10;0:00:23;0:02:28;0:02:50;68,97;44934
199;214;201;93,93;13;0:00:23;0:02:11;0:02:24;66,03;44934
200;169;161;95,27;8;0:00:23;0:02:17;0:04:35;71,69;44934
201;46;46;100;0;0:00:25;0:02:24;0:01:35;71,74;44934
202;183;177;96,72;6;0:00:18;0:02:30;0:01:07;81,11;44934
203;208;190;91,35;18;0:00:21;0:02:25;0:01:50;74,11;44934
204;234;224;95,73;10;0:00:22;0:02:15;0:03:20;74,14;44934
205;204;194;95,1;10;0:00:18;0:02:17;0:01:50;78,71;44934
206;204;189;92,65;15;0:00:21;0:02:15;0:03:56;70,79;44934
207;99;99;100;0;0:00:16;0:02:25;0:01:02;82,83;44934
208;29;27;93,1;2;0:00:19;0:02:47;0:02:22;78,57;44934
209;167;159;95,21;8;0:00:23;0:02:28;0:04:35;70,48;44935
210;164;161;98,17;3;0:00:17;0:02:35;0:01:37;81,71;44935
211;158;147;93,04;11;0:00:21;0:02:34;0:02:03;72,44;44935
212;165;161;97,58;4;0:00:17;0:02:26;0:01:06;77,91;44935
213;129;124;96,12;5;0:00:23;0:02:28;0:01:50;70,87;44935
214;155;149;96,13;6;0:00:23;0:02:26;0:04:19;74,51;44935
215;24;22;91,67;2;0:00:28;0:02:24;0:01:21;54,17;44935
216;209;200;95,69;9;0:00:23;0:02:24;0:02:11;66,67;44935
217;239;226;94,56;13;0:00:26;0:02:19;0:02:50;67,23;44935
218;229;210;91,7;19;0:00:29;0:02:23;0:08:16;64,16;44935
219;194;172;88,66;22;0:00:23;0:02:20;0:06:16;66,14;44935
220;202;179;88,61;23;0:00:24;0:02:16;0:02:50;64,43;44935
221;268;254;94,78;14;0:00:15;0:01:51;0:02:40;81,13;44935
222;52;49;94,23;3;0:00:18;0:02:18;0:02:17;76,47;44935
223;414;397;95,89;17;0:00:23;0:01:58;0:05:32;70,73;44935
224;346;325;93,93;21;0:00:27;0:02:22;0:02:45;65,69;44935
225;187;179;95,72;8;0:00:25;0:02:14;0:02:59;67,03;44935
226;203;186;91,63;17;0:00:24;0:02:38;0:04:35;69,59;44935
227;204;194;95,1;10;0:00:18;0:02:33;0:02:02;82,41;44935
228;126;121;96,03;5;0:00:21;0:02:32;0:01:51;70,63;44935
229;36;36;100;0;0:00:17;0:02:07;0:01:31;77,78;44935
230;180;165;91,67;15;0:00:27;0:02:30;0:02:19;66,09;44935
231;169;162;95,86;7;0:00:20;0:02:25;0:01:53;74,56;44935
232;155;151;97,42;4;0:00:21;0:02:20;0:02:45;70,97;44935
233;169;137;81,07;32;0:00:38;0:02:24;0:05:30;40,36;44935
234;61;45;73,77;16;0:00:32;0:02:49;0:05:30;40,98;44935
235;167;136;81,44;31;0:00:42;0:02:36;0:05:28;35,98;44936
236;32;27;84,38;5;0:00:35;0:02:22;0:03:10;53,13;44936
237;229;148;64,63;81;0:00:36;0:02:48;0:10:39;43,18;44936
238;208;204;98,08;4;0:00:19;0:03:06;0:05:14;77,67;44936
239;175;168;96;7;0:00:25;0:02:51;0:03:44;65,12;44936
240;177;167;94,35;10;0:00:22;0:02:41;0:04:24;68,39;44936
241;822;767;93,31;55;0:00:24;0:01:25;0:04:35;64,4;44936
242;87;85;97,7;2;0:00:23;0:02:25;0:02:17;67,82;44936
243;41;39;95,12;2;0:00:15;0:02:42;0:01:18;82,5;44936
244;280;257;91,79;23;0:00:31;0:02:33;0:07:55;63,87;44936
245;199;192;96,48;7;0:00:22;0:02:46;0:02:48;73,87;44936
246;252;239;94,84;13;0:00:29;0:02:29;0:03:36;64,92;44936
247;220;208;94,55;12;0:00:20;0:02:36;0:02:45;75,59;44936
248;206;193;93,69;13;0:00:24;0:02:27;0:03:37;75,49;44936
249;217;206;94,93;11;0:00:22;0:02:26;0:02:02;71,03;44936
250;24;24;100;0;0:00:19;0:02:50;0:01:07;79,17;44936
251;248;238;95,97;10;0:00:13;0:02:27;0:01:50;85,25;44936
252;222;212;95,5;10;0:00:20;0:02:25;0:03:41;77,73;44936
253;190;178;93,68;12;0:00:32;0:02:27;0:02:45;55,08;44936
254;238;231;97,06;7;0:00:20;0:02:27;0:02:03;79,66;44936
255;214;205;95,79;9;0:00:20;0:02:34;0:02:34;79,05;44936
256;186;176;94,62;10;0:00:23;0:02:15;0:05:03;70,88;44936
257;21;20;95,24;1;0:00:14;0:02:25;0:00:54;85;44936
258;169;157;92,9;12;0:00:21;0:02:29;0:04:30;77,71;44936
259;149;141;94,63;8;0:00:16;0:02:38;0:02:37;79,05;44936
260;171;164;95,91;7;0:00:19;0:02:22;0:03:49;77,19;44936
261;127;122;96,06;5;0:00:13;0:02:22;0:01:25;87,8;44937
262;21;21;100;0;0:00:08;0:03:03;0:00:58;90,48;44937
263;5;5;100;0;0:00:14;0:02:37;0:00:59;80;44937
264;33;32;96,97;1;0:00:26;0:02:04;0:01:45;66,67;44937
265;145;139;95,86;6;0:00:20;0:02:28;0:03:41;79,02;44937
266;129;127;98,45;2;0:00:19;0:02:13;0:01:49;75,59;44937
267;194;178;91,75;16;0:00:26;0:02:36;0:05:20;67,19;44937
268;194;187;96,39;7;0:00:24;0:02:25;0:03:44;77,25;44937
269;202;195;96,53;7;0:00:21;0:02:21;0:02:59;74,75;44937
270;214;208;97,2;6;0:00:13;0:02:19;0:00:57;88,15;44937
271;28;28;100;0;0:00:13;0:02:13;0:01:18;89,29;44937
272;191;187;97,91;4;0:00:15;0:02:23;0:01:40;82,54;44937
273;205;197;96,1;8;0:00:21;0:02:27;0:02:23;74,38;44937
274;198;196;98,99;2;0:00:23;0:02:28;0:02:03;73,6;44937
275;184;177;96,2;7;0:00:20;0:02:41;0:01:50;78,57;44937
276;184;174;94,57;10;0:00:25;0:02:27;0:02:47;70;44937
277;168;160;95,24;8;0:00:26;0:02:25;0:02:04;68,26;44937
278;39;37;94,87;2;0:00:14;0:02:08;0:01:03;81,08;44937
279;225;210;93,33;15;0:00:28;0:02:13;0:02:33;66,97;44937
280;182;174;95,6;8;0:00:32;0:02:16;0:03:56;60,22;44937
281;346;305;88,15;41;0:00:45;0:01:57;0:05:07;45,03;44937
282;450;441;98;9;0:00:19;0:01:53;0:02:31;78,3;44937
283;259;248;95,75;11;0:00:20;0:02:06;0:01:51;75,39;44937
284;231;214;92,64;17;0:00:18;0:02:06;0:02:31;79,56;44937
285;48;47;97,92;1;0:00:13;0:02:03;0:01:46;89,58;44937
286;246;236;95,93;10;0:00:20;0:02:11;0:04:36;79,18;44937
287;202;195;96,53;7;0:00:25;0:02:15;0:05:33;74,5;44938
288;153;150;98,04;3;0:00:15;0:02:15;0:02:12;82,24;44938
289;178;172;96,63;6;0:00:19;0:02:15;0:04:35;78,29;44938
290;172;165;95,93;7;0:00:19;0:02:24;0:03:24;79,29;44938
291;208;200;96,15;8;0:00:26;0:02:23;0:03:15;68,78;44938
292;77;76;98,7;1;0:00:29;0:02:16;0:01:54;58,44;44938
293;291;250;85,91;41;0:00:41;0:02:20;0:07:10;55,44;44938
294;219;212;96,8;7;0:00:21;0:02:19;0:01:50;76,85;44938
295;173;169;97,69;4;0:00:18;0:02:13;0:02:14;81,4;44938
296;204;197;96,57;7;0:00:17;0:02:23;0:01:57;80;44938
297;216;185;85,65;31;0:00:30;0:02:17;0:06:26;61,43;44938
298;461;441;95,66;20;0:00:30;0:02:18;0:03:40;61,49;44938
299;56;55;98,21;1;0:00:26;0:02:11;0:01:53;66,07;44938
300;192;176;91,67;16;0:00:23;0:02:05;0:02:47;68,28;44938
301;382;365;95,55;17;0:00:20;0:01:35;0:02:53;73,14;44938
302;246;223;90,65;23;0:00:25;0:02:14;0:05:24;71,67;44938
303;48;46;95,83;2;0:00:26;0:02:14;0:01:25;72,34;44938
304;221;205;92,76;16;0:00:26;0:02:15;0:03:15;63,08;44938
305;275;261;94,91;14;0:00:33;0:02:19;0:02:58;58,52;44938
306;39;36;92,31;3;0:00:19;0:01:53;0:01:52;77,78;44938
307;250;236;94,4;14;0:00:29;0:02:08;0:04:07;59,04;44938
308;197;184;93,4;13;0:00:29;0:02:23;0:03:41;55,61;44938
309;223;208;93,27;15;0:00:28;0:02:21;0:06:51;72,27;44938
310;240;236;98,33;4;0:00:18;0:02:14;0:02:08;77,92;44938
311;55;52;94,55;3;0:00:16;0:02:19;0:01:42;78,18;44938
312;59;54;91,53;5;0:00:08;0:02:06;0:02:01;84,75;44938
313;36;31;86,11;5;0:00:11;0:02:22;0:01:56;72,22;44939
314;229;219;95,63;10;0:00:13;0:02:07;0:02:35;84,89;44939
315;206;189;91,75;17;0:00:15;0:02:19;0:03:48;82,83;44939
316;225;200;88,89;25;0:00:21;0:02:21;0:04:42;73,11;44939
317;200;193;96,5;7;0:00:17;0:02:23;0:03:40;79,29;44939
318;189;179;94,71;10;0:00:22;0:02:10;0:06:41;78,07;44939
319;169;159;94,08;10;0:00:22;0:02:23;0:03:26;73,65;44939
320;41;40;97,56;1;0:00:25;0:02:32;0:02:05;68,29;44939
321;218;187;85,78;31;0:00:48;0:02:15;0:05:13;52,11;44939
322;194;185;95,36;9;0:00:21;0:02:10;0:02:45;71,58;44939
323;176;172;97,73;4;0:00:16;0:02:20;0:02:15;82,08;44939
324;181;179;98,9;2;0:00:18;0:02:21;0:02:17;80,56;44939
325;159;151;94,97;8;0:00:29;0:01:59;0:03:41;61,01;44939
326;144;135;93,75;9;0:00:24;0:02:12;0:06:25;70,63;44939
327;30;29;96,67;1;0:00:33;0:02:58;0:02:16;60;44939
328;197;185;93,91;12;0:00:24;0:02:18;0:02:20;68,23;44939
329;56;47;83,93;9;0:00:24;0:02:22;0:02:48;58,93;44939
330;182;153;84,07;29;0:00:38;0:02:17;0:10:41;53,89;44939
331;178;166;93,26;12;0:00:30;0:02:24;0:05:12;62,07;44939
332;183;164;89,62;19;0:00:25;0:02:04;0:03:40;65,91;44939
333;197;182;92,39;15;0:00:28;0:02:25;0:04:20;64,8;44939
334;60;58;96,67;2;0:00:37;0:02:36;0:03:10;54,24;44939
335;241;224;92,95;17;0:00:23;0:02:25;0:02:45;70,46;44939
336;307;295;96,09;12;0:00:29;0:02:16;0:02:45;60,46;44939
337;295;289;97,97;6;0:00:26;0:02:23;0:03:11;70,69;44939
338;239;230;96,23;9;0:00:26;0:02:14;0:03:14;68,91;44939
339;241;231;95,85;10;0:00:23;0:02:25;0:01:52;72,46;44940
340;211;195;92,42;16;0:00:33;0:02:42;0:03:16;52,4;44940
341;40;35;87,5;5;0:00:40;0:02:35;0:03:12;47,5;44940
342;192;174;90,63;18;0:00:32;0:02:16;0:03:40;55,79;44940
343;201;179;89,05;22;0:00:35;0:02:18;0:03:40;57,29;44940
344;274;247;90,15;27;0:00:28;0:02:10;0:04:04;63,94;44940
345;205;176;85,85;29;0:00:41;0:02:16;0:05:11;46,23;44940
346;177;160;90,4;17;0:00:28;0:02:20;0:03:59;59,2;44940
347;159;151;94,97;8;0:00:22;0:02:08;0:07:22;73,25;44940
348;33;28;84,85;5;0:00:13;0:02:30;0:01:02;66,67;44940
349;228;210;92,11;18;0:00:23;0:02:08;0:03:09;66,67;44940
350;177;172;97,18;5;0:00:25;0:02:15;0:02:52;69,14;44940
351;197;169;85,79;28;0:00:34;0:02:30;0:07:41;55,67;44940
352;721;616;85,44;105;0:00:57;0:01:55;0:05:48;28,31;44940
353;301;270;89,7;31;0:00:42;0:02:05;0:10:06;42,47;44940
354;179;175;97,77;4;0:00:24;0:02:21;0:03:12;71,35;44940
355;45;45;100;0;0:00:16;0:02:11;0:03:21;86,67;44940
356;180;164;91,11;16;0:00:25;0:02:22;0:01:50;61,8;44940
357;206;200;97,09;6;0:00:22;0:02:19;0:02:07;74,63;44940
358;187;181;96,79;6;0:00:32;0:02:30;0:03:54;62,7;44940
359;186;177;95,16;9;0:00:28;0:02:22;0:05:30;67,93;44940
360;189;180;95,24;9;0:00:35;0:02:15;0:03:24;56,45;44940
361;127;116;91,34;11;0:00:34;0:02:25;0:02:46;56,45;44940
362;93;90;96,77;3;0:00:26;0:01:57;0:02:57;63,44;44940
363;328;292;89,02;36;0:00:37;0:02:17;0:06:25;49,68;44940
364;238;223;93,7;15;0:00:33;0:02:23;0:03:40;59,23;44940
365;237;222;93,67;15;0:00:34;0:02:24;0:02:52;53,85;44941
366;257;235;91,44;22;0:00:45;0:02:31;0:04:24;44,66;44941
367;238;223;93,7;15;0:00:32;0:02:17;0:03:22;54,7;44941
368;199;164;82,41;35;0:00:32;0:02:13;0:06:56;59,18;44941
369;30;27;90;3;0:00:32;0:02:34;0:02:37;60,71;44941
370;176;163;92,61;13;0:00:38;0:02:05;0:05:30;54,29;44941
371;162;144;88,89;18;0:00:41;0:02:25;0:03:40;50,31;44941
372;169;157;92,9;12;0:00:29;0:02:29;0:01:56;53,89;44941
373;155;146;94,19;9;0:00:30;0:02:18;0:03:10;50,98;44941
374;247;205;83;42;0:00:49;0:02:26;0:07:36;38,49;44941
375;191;186;97,38;5;0:00:24;0:02:14;0:01:54;70,53;44941
376;30;29;96,67;1;0:00:06;0:02:15;0:00:46;93,33;44941
377;316;290;91,77;26;0:00:31;0:02:21;0:04:02;59,16;44941
378;211;195;92,42;16;0:00:34;0:02:21;0:06:25;55,77;44941
379;208;169;81,25;39;0:00:45;0:02:18;0:07:15;45,85;44941
380;130;124;95,38;6;0:00:22;0:02:17;0:02:15;68,99;44941
381;134;129;96,27;5;0:00:24;0:02:12;0:03:28;70,9;44941
382;124;121;97,58;3;0:00:27;0:02:19;0:03:19;70,73;44941
383;47;43;91,49;4;0:00:37;0:02:18;0:03:16;54,35;44941
384;197;186;94,42;11;0:00:28;0:02:18;0:02:27;63,83;44941
385;158;146;92,41;12;0:00:31;0:02:24;0:03:40;56,96;44941
386;163;151;92,64;12;0:00:28;0:02:13;0:04:53;63,75;44941
387;178;160;89,89;18;0:00:35;0:02:39;0:04:41;54,49;44941
388;151;128;84,77;23;0:00:35;0:02:23;0:05:38;53,38;44941
389;118;106;89,83;12;0:00:33;0:02:25;0:04:32;55,17;44941
390;31;28;90,32;3;0:00:40;0:02:40;0:03:12;43,33;44941
391;139;134;96,4;5;0:00:31;0:02:23;0:02:50;59,42;44942
392;171;154;90,06;17;0:00:27;0:02:24;0:06:28;65,66;44942
393;160;156;97,5;4;0:00:27;0:02:15;0:01:47;64,56;44942
394;177;169;95,48;8;0:00:29;0:02:31;0:03:40;64,37;44942
395;187;180;96,26;7;0:00:26;0:02:22;0:05:56;65,59;44942
396;147;138;93,88;9;0:00:26;0:02:24;0:05:19;61,38;44942
397;35;35;100;0;0:00:08;0:02:10;0:00:47;88,57;44942
398;208;194;93,27;14;0:00:35;0:02:26;0:04:26;56,93;44942
399;162;155;95,68;7;0:00:19;0:02:17;0:03:43;77,99;44942
400;152;143;94,08;9;0:00:22;0:02:28;0:03:41;70;44942
401;132;125;94,7;7;0:00:26;0:02:07;0:03:52;68,94;44942
402;133;131;98,5;2;0:00:12;0:02:19;0:01:19;87,12;44942
403;129;121;93,8;8;0:00:33;0:02:37;0:04:01;61,42;44942
404;37;35;94,59;2;0:00:19;0:02:21;0:01:32;75,68;44942
405;56;54;96,43;2;0:00:13;0:02:33;0:02:13;87,27;44942
406;215;210;97,67;5;0:00:12;0:01:34;0:01:42;87,74;44942
407;50;46;92;4;0:00:14;0:02:42;0:01:13;72;44942
408;136;129;94,85;7;0:00:22;0:02:26;0:02:30;66,42;44942
409;160;142;88,75;18;0:00:35;0:02:34;0:03:10;55,92;44942
410;132;115;87,12;17;0:00:36;0:02:27;0:04:35;48,84;44942
411;30;28;93,33;2;0:00:47;0:02:36;0:02:22;40;44942
412;150;140;93,33;10;0:00:29;0:02:32;0:02:11;63,09;44942
413;160;144;90;16;0:00:46;0:02:39;0:04:25;49,68;44942
414;132;122;92,42;10;0:00:37;0:02:38;0:03:51;50;44942
415;161;151;93,79;10;0:00:28;0:02:07;0:02:50;61,39;44942
416;156;149;95,51;7;0:00:22;0:02:28;0:04:11;70,32;44942
417;137;128;93,43;9;0:00:31;0:02:30;0:05:04;62,69;44943
418;28;25;89,29;3;0:01:00;0:02:47;0:04:46;32,14;44943
419;141;133;94,33;8;0:00:33;0:02:42;0:04:38;63,31;44943
420;130;123;94,62;7;0:00:32;0:02:40;0:02:20;53,49;44943
421;161;155;96,27;6;0:00:27;0:02:43;0:02:43;73,58;44943
422;139;132;94,96;7;0:00:28;0:02:40;0:01:51;63,31;44943
423;167;130;77,84;37;0:00:29;0:02:34;0:11:56;54,6;44943
424;138;122;88,41;16;0:00:35;0:02:49;0:05:30;57,78;44943
425;47;44;93,62;3;0:00:26;0:03:11;0:03:29;63,04;44943
426;230;206;89,57;24;0:00:38;0:02:34;0:04:35;46,72;44943
427;177;153;86,44;24;0:00:30;0:02:53;0:04:28;55,49;44943
428;159;149;93,71;10;0:00:33;0:02:40;0:04:32;61,04;44943
429;151;135;89,4;16;0:00:36;0:02:32;0:04:41;52,74;44943
430;138;126;91,3;12;0:00:34;0:02:17;0:04:10;59,7;44943
431;118;118;100;0;0:00:26;0:02:33;0:01:38;66,1;44943
432;22;21;95,45;1;0:00:42;0:02:24;0:02:56;52,38;44943
433;177;156;88,14;21;0:00:42;0:02:39;0:03:16;42,37;44943
434;156;147;94,23;9;0:00:29;0:02:31;0:03:41;63,64;44943
435;123;121;98,37;2;0:00:26;0:02:28;0:03:29;64,23;44943
436;130;125;96,15;5;0:00:26;0:02:29;0:03:28;66,93;44943
437;141;134;95,04;7;0:00:39;0:02:33;0:03:08;56,43;44943
438;121;113;93,39;8;0:00:38;0:02:38;0:04:18;50,83;44943
439;35;31;88,57;4;0:00:34;0:02:05;0:04:29;47,06;44943
440;240;226;94,17;14;0:00:36;0:02:15;0:04:06;57,02;44943
441;130;118;90,77;12;0:00:32;0:02:23;0:03:40;57,81;44943
442;140;130;92,86;10;0:00:29;0:02:31;0:07:35;62,32;44943
443;131;111;84,73;20;0:00:38;0:03:16;0:09:59;59,69;44944
444;74;74;100;0;0:00:13;0:02:55;0:01:53;89,19;44944
445;24;24;100;0;0:00:12;0:02:47;0:00:57;83,33;44944
446;11;10;90,91;1;0:00:13;0:02:24;0:00:55;81,82;44944
447;28;26;92,86;2;0:00:10;0:02:30;0:01:26;81,48;44944
448;43;43;100;0;0:00:08;0:02:23;0:00:52;88,37;44944
449;62;62;100;0;0:00:17;0:02:12;0:01:26;82,26;44944
450;70;69;98,57;1;0:00:22;0:02:06;0:08:40;81,43;44944
451;107;97;90,65;10;0:00:21;0:02:26;0:02:40;68,87;44944
452;91;85;93,41;6;0:00:30;0:02:27;0:05:49;62,64;44944
453;25;25;100;0;0:00:11;0:02:40;0:00:55;84;44944
454;85;79;92,94;6;0:00:24;0:02:31;0:03:07;72,29;44944
455;91;83;91,21;8;0:00:26;0:02:37;0:03:40;62,64;44944
456;48;46;95,83;2;0:00:11;0:02:13;0:01:22;82,98;44944
457;14;11;78,57;3;0:00:18;0:02:27;0:02:45;61,54;44944
458;43;42;97,67;1;0:00:22;0:02:47;0:03:15;73,81;44944
459;74;69;93,24;5;0:00:23;0:02:31;0:04:48;76,71;44944
460;33;33;100;0;0:00:14;0:02:25;0:01:29;81,82;44944
461;124;112;90,32;12;0:00:26;0:02:36;0:05:30;64,75;44944
462;130;126;96,92;4;0:00:25;0:02:30;0:02:58;65,89;44944
463;139;139;100;0;0:00:18;0:02:40;0:03:03;77,54;44944
464;138;130;94,2;8;0:00:26;0:02:27;0:01:52;61,48;44944
465;125;119;95,2;6;0:00:22;0:02:29;0:03:40;68;44944
466;98;96;97,96;2;0:00:20;0:02:36;0:02:53;77,32;44944
467;12;12;100;0;0:00:18;0:03:07;0:01:36;83,33;44944
468;119;117;98,32;2;0:00:18;0:02:39;0:02:43;78,15;44944
469;100;96;96;4;0:00:21;0:02:37;0:02:45;76;44945
470;146;133;91,1;13;0:00:31;0:02:30;0:03:40;57,75;44945
471;131;127;96,95;4;0:00:22;0:02:25;0:02:28;72,66;44945
472;107;104;97,2;3;0:00:08;0:02:27;0:01:36;92,45;44945
473;112;105;93,75;7;0:00:24;0:02:38;0:04:28;67,27;44945
474;21;21;100;0;0:00:32;0:02:31;0:01:25;52,38;44945
475;125;104;83,2;21;0:00:37;0:02:44;0:02:45;44,63;44945
476;35;34;97,14;1;0:00:24;0:02:12;0:02:16;74,29;44945
477;121;109;90,08;12;0:00:38;0:02:32;0:05:21;53,78;44945
478;135;122;90,37;13;0:00:32;0:02:34;0:03:08;57,58;44945
479;117;114;97,44;3;0:00:22;0:02:38;0:02:27;75,86;44945
480;114;97;85,09;17;0:00:39;0:02:50;0:08:16;45,13;44945
481;50;49;98;1;0:00:35;0:02:55;0:02:22;52;44945
482;207;198;95,65;9;0:00:16;0:02:43;0:03:51;80,49;44945
483;189;183;96,83;6;0:00:21;0:02:31;0:03:58;74,19;44945
484;162;156;96,3;6;0:00:24;0:02:22;0:02:08;66,46;44945
485;177;165;93,22;12;0:00:26;0:02:31;0:03:50;66,47;44945
486;177;167;94,35;10;0:00:23;0:02:35;0:02:45;68,97;44945
487;163;134;82,21;29;0:00:38;0:02:42;0:07:16;47,2;44945
488;24;20;83,33;4;0:00:26;0:03:23;0:02:16;65,22;44945
489;146;139;95,21;7;0:00:18;0:02:34;0:06:21;75,86;44945
490;143;141;98,6;2;0:00:22;0:02:45;0:02:45;72,03;44945
491;132;122;92,42;10;0:00:31;0:02:28;0:04:36;56,49;44945
492;137;130;94,89;7;0:00:26;0:02:25;0:02:06;64,44;44945
493;112;104;92,86;8;0:00:43;0:02:37;0:04:07;40,91;44945
494;110;91;82,73;19;0:00:50;0:02:38;0:05:12;36,7;44945
495;24;22;91,67;2;0:00:32;0:02:14;0:04:46;58,33;44946
496;168;154;91,67;14;0:00:36;0:02:44;0:03:52;49,4;44946
497;146;116;79,45;30;0:00:42;0:02:28;0:15:00;54,93;44946
498;100;95;95;5;0:00:31;0:02:38;0:02:53;57;44946
499;144;131;90,97;13;0:00:26;0:02:27;0:02:37;63,57;44946
500;110;104;94,55;6;0:00:24;0:02:26;0:02:22;64,22;44946
501;126;111;88,1;15;0:00:31;0:02:38;0:04:36;52,8;44946
502;24;24;100;0;0:00:48;0:02:54;0:04:44;41,67;44946
503;128;122;95,31;6;0:00:35;0:02:59;0:02:42;51,56;44946
504;185;176;95,14;9;0:00:27;0:02:23;0:05:05;67,93;44946
505;136;114;83,82;22;0:00:57;0:02:25;0:05:31;28,79;44946
506;130;116;89,23;14;0:00:44;0:02:41;0:06:00;44,44;44946
507;103;101;98,06;2;0:00:18;0:02:42;0:02:23;77,45;44946
508;99;89;89,9;10;0:00:20;0:02:27;0:01:30;73,68;44946
509;26;24;92,31;2;0:00:23;0:02:00;0:01:53;68;44946
510;95;94;98,95;1;0:00:21;0:02:31;0:03:34;75,53;44946
511;136;131;96,32;5;0:00:17;0:02:29;0:02:21;81,06;44946
512;37;34;91,89;3;0:00:41;0:02:11;0:05:46;64,86;44946
513;105;100;95,24;5;0:00:22;0:02:30;0:02:12;72,28;44946
514;100;92;92;8;0:00:30;0:02:27;0:04:35;63,27;44946
515;115;103;89,57;12;0:00:44;0:02:46;0:04:35;37,17;44946
516;38;36;94,74;2;0:00:39;0:02:56;0:02:54;52,63;44946
517;108;95;87,96;13;0:00:26;0:02:49;0:02:46;63,81;44946
518;124;118;95,16;6;0:00:23;0:02:31;0:03:01;73,77;44946
519;97;92;94,85;5;0:00:25;0:02:36;0:02:23;67,71;44946
520;117;108;92,31;9;0:00:37;0:01:46;0:04:03;48,67;44946
521;34;31;91,18;3;0:00:27;0:02:37;0:02:32;64,71;44947
522;53;50;94,34;3;0:00:28;0:02:11;0:03:16;66,04;44947
523;29;23;79,31;6;0:00:42;0:02:47;0:03:40;32,14;44947
524;120;107;89,17;13;0:00:34;0:02:39;0:03:21;44,07;44947
525;107;100;93,46;7;0:00:33;0:02:33;0:02:08;51,43;44947
526;173;159;91,91;14;0:00:47;0:02:44;0:05:30;39,41;44947
527;256;213;83,2;43;0:00:44;0:02:45;0:05:18;41,7;44947
528;199;174;87,44;25;0:00:36;0:02:35;0:04:35;53,06;44947
529;182;170;93,41;12;0:00:40;0:02:44;0:03:27;45,81;44947
530;42;41;97,62;1;0:00:42;0:02:53;0:03:40;56,1;44947
531;181;168;92,82;13;0:00:34;0:02:35;0:02:43;51,69;44947
532;159;147;92,45;12;0:00:30;0:02:36;0:04:39;58,71;44947
533;142;134;94,37;8;0:00:26;0:02:50;0:01:50;61,87;44947
534;194;163;84,02;31;0:00:30;0:02:38;0:05:31;51,04;44947
535;235;210;89,36;25;0:00:38;0:02:53;0:04:35;48,9;44947
536;206;180;87,38;26;0:00:51;0:02:47;0:07:03;38,61;44947
537;58;47;81,03;11;0:00:48;0:02:36;0:04:35;42,11;44947
538;212;194;91,51;18;0:00:38;0:02:33;0:04:21;51,2;44947
539;232;214;92,24;18;0:00:34;0:02:36;0:05:30;55,9;44947
540;348;327;93,97;21;0:00:32;0:02:28;0:07:20;54,62;44947
541;167;156;93,41;11;0:00:32;0:02:43;0:02:57;56,79;44947
542;167;157;94,01;10;0:00:27;0:02:57;0:05:19;67,48;44947
543;166;161;96,99;5;0:00:21;0:02:45;0:01:32;73,33;44947
544;32;28;87,5;4;0:00:22;0:02:43;0:07:35;64,52;44947
545;52;49;94,23;3;0:00:32;0:02:58;0:03:02;63,46;44947
546;154;149;96,75;5;0:00:26;0:02:52;0:01:50;64,9;44947
547;223;218;97,76;5;0:00:18;0:02:07;0:02:00;80,09;44948
548;170;157;92,35;13;0:00:17;0:03:04;0:06:25;78,44;44948
549;145;133;91,72;12;0:00:26;0:02:56;0:03:39;69,23;44948
550;144;138;95,83;6;0:00:17;0:02:53;0:02:45;83,8;44948
551;16;15;93,75;1;0:00:17;0:03:00;0:02:45;68,75;44948
552;135;131;97,04;4;0:00:20;0:02:37;0:02:00;76,12;44948
553;137;133;97,08;4;0:00:24;0:02:49;0:02:46;69,12;44948
554;149;144;96,64;5;0:00:17;0:02:39;0:02:02;82,76;44948
555;155;143;92,26;12;0:00:16;0:02:41;0:06:25;80,14;44948
556;128;121;94,53;7;0:00:19;0:02:55;0:04:35;77,78;44948
557;134;125;93,28;9;0:00:21;0:02:38;0:03:18;72,52;44948
558;21;21;100;0;0:00:23;0:02:37;0:02:50;76,19;44948
559;150;138;92;12;0:00:30;0:02:52;0:04:16;58,67;44948
560;163;158;96,93;5;0:00:14;0:02:28;0:02:01;81,99;44948
561;160;151;94,38;9;0:00:12;0:02:39;0:02:57;87,18;44948
562;132;125;94,7;7;0:00:30;0:02:46;0:03:47;64,62;44948
563;131;126;96,18;5;0:00:17;0:02:47;0:02:35;78,29;44948
564;158;146;92,41;12;0:00:21;0:02:42;0:03:40;75,32;44948
565;19;16;84,21;3;0:00:51;0:02:46;0:04:14;47,37;44948
566;151;128;84,77;23;0:00:52;0:02:30;0:05:38;37,93;44948
567;139;128;92,09;11;0:00:32;0:02:44;0:03:34;51,8;44948
568;166;135;81,33;31;0:00:41;0:02:40;0:05:09;46,5;44948
569;258;196;75,97;62;0:01:10;0:02:30;0:07:51;24,29;44948
570;203;176;86,7;27;0:00:40;0:02:30;0:09:09;44,78;44948
571;182;162;89,01;20;0:00:25;0:02:48;0:03:40;59,43;44948
572;18;17;94,44;1;0:00:55;0:04:01;0:05:46;50;44948
573;215;170;79,07;45;0:00:55;0:02:49;0:07:26;43,06;44949
574;209;203;97,13;6;0:00:25;0:02:42;0:03:40;74,88;44949
575;140;134;95,71;6;0:00:20;0:02:59;0:03:21;76,26;44949
576;124;110;88,71;14;0:00:15;0:02:56;0:08:16;81,82;44949
577;179;163;91,06;16;0:00:23;0:02:44;0:04:17;71,59;44949
578;163;161;98,77;2;0:00:10;0:02:40;0:01:51;94,41;44949
579;27;27;100;0;0:00:05;0:02:48;0:00:19;100;44949
580;182;175;96,15;7;0:00:19;0:02:38;0:03:08;79,89;44949
581;164;159;96,95;5;0:00:11;0:02:23;0:06:28;90,18;44949
582;160;159;99,38;1;0:00:05;0:02:40;0:00:58;98,74;44949
583;174;155;89,08;19;0:00:16;0:02:41;0:06:39;77,06;44949
584;235;230;97,87;5;0:00:05;0:02:27;0:01:50;95,74;44949
585;175;174;99,43;1;0:00:04;0:02:26;0:01:53;98,86;44949
586;25;25;100;0;0:00:04;0:03:15;0:00:55;96;44949
587;170;167;98,24;3;0:00:06;0:02:35;0:03:40;94,08;44949
588;187;168;89,84;19;0:00:26;0:02:20;0:04:49;70,43;44949
589;53;51;96,23;2;0:00:06;0:02:29;0:01:50;88,68;44949
590;121;117;96,69;4;0:00:13;0:02:36;0:02:41;85,83;44949
591;143;139;97,2;4;0:00:05;0:02:26;0:01:56;94,41;44949
592;100;96;96;4;0:00:06;0:02:28;0:01:50;91,92;44949
593;17;17;100;0;0:00:08;0:02:55;0:00:59;88,24;44949
594;113;110;97,35;3;0:00:08;0:02:33;0:01:18;90,18;44949
595;139;128;92,09;11;0:00:13;0:02:38;0:03:40;82,01;44949
596;135;134;99,26;1;0:00:04;0:02:34;0:01:50;98,52;44949
597;29;29;100;0;0:00:15;0:03:13;0:01:29;79,31;44949
598;120;116;96,67;4;0:00:05;0:02:43;0:02:45;95,83;44949
599;115;108;93,91;7;0:00:09;0:02:50;0:04:25;88,7;44950
600;14;14;100;0;0:00:14;0:02:17;0:01:14;78,57;44950
601;107;104;97,2;3;0:00:07;0:02:29;0:00:58;90,57;44950
602;137;128;93,43;9;0:00:10;0:02:30;0:02:03;85,29;44950
603;106;105;99,06;1;0:00:11;0:02:47;0:01:53;85,85;44950
604;116;108;93,1;8;0:00:19;0:02:26;0:02:33;84,07;44950
605;120;117;97,5;3;0:00:09;0:02:37;0:01:05;90,76;44950
606;123;121;98,37;2;0:00:07;0:02:27;0:01:55;91,06;44950
607;31;31;100;0;0:00:03;0:02:18;0:00:03;100;44950
608;140;139;99,29;1;0:00:08;0:02:39;0:01:11;92,14;44950
609;168;161;95,83;7;0:00:18;0:02:24;0:02:24;73,65;44950
610;146;144;98,63;2;0:00:06;0:02:38;0:00:58;94,48;44950
611;110;106;96,36;4;0:00:15;0:02:50;0:02:30;80;44950
612;342;333;97,37;9;0:00:15;0:02:10;0:02:39;81,42;44950
613;190;183;96,32;7;0:00:16;0:02:32;0:01:59;78,95;44950
614;25;24;96;1;0:00:06;0:02:22;0:00:48;91,67;44950
615;169;162;95,86;7;0:00:09;0:02:31;0:04:36;89,16;44950
616;130;129;99,23;1;0:00:11;0:02:30;0:01:52;86,92;44950
617;22;20;90,91;2;0:00:09;0:03:15;0:01:50;90,48;44950
618;5;5;100;0;0:00:28;0:02:25;0:01:14;60;44950
619;119;115;96,64;4;0:00:11;0:02:28;0:01:50;86,44;44950
620;140;138;98,57;2;0:00:09;0:02:17;0:02:11;92,14;44950
621;22;22;100;0;0:00:06;0:02:21;0:00:48;90,91;44950
622;126;124;98,41;2;0:00:08;0:02:35;0:00:58;94,4;44950
623;122;111;90,98;11;0:00:13;0:02:43;0:02:13;77,69;44950
624;113;108;95,58;5;0:00:13;0:02:31;0:01:27;82,88;44950
625;119;109;91,6;10;0:00:17;0:02:36;0:05:15;83,62;44951
626;134;119;88,81;15;0:00:24;0:02:46;0:02:45;63,43;44951
627;101;97;96,04;4;0:00:16;0:02:33;0:01:38;77;44951
628;20;20;100;0;0:00:04;0:02:24;0:00:18;100;44951
629;169;162;95,86;7;0:00:17;0:02:32;0:05:31;80,12;44951
630;137;133;97,08;4;0:00:29;0:02:37;0:02:42;62,04;44951
631;133;127;95,49;6;0:00:18;0:02:39;0:04:36;81,95;44951
632;184;179;97,28;5;0:00:10;0:02:03;0:02:44;90,56;44951
633;145;135;93,1;10;0:00:21;0:02:35;0:03:10;74,13;44951
634;114;108;94,74;6;0:00:14;0:02:31;0:02:33;82,88;44951
635;24;23;95,83;1;0:00:05;0:02:12;0:00:55;95,83;44951
636;143;136;95,1;7;0:00:09;0:02:32;0:05:30;84,51;44951
637;119;114;95,8;5;0:00:08;0:02:22;0:01:19;90,6;44951
638;123;118;95,93;5;0:00:21;0:02:46;0:02:44;70,73;44951
639;145;141;97,24;4;0:00:14;0:02:36;0:01:50;83,33;44951
640;108;106;98,15;2;0:00:26;0:02:50;0:04:57;68,22;44951
641;128;125;97,66;3;0:00:13;0:02:45;0:01:42;82,68;44951
642;27;26;96,3;1;0:00:20;0:02:51;0:02:40;84,62;44951
643;155;151;97,42;4;0:00:11;0:02:32;0:02:18;89,61;44951
644;116;110;94,83;6;0:00:18;0:02:23;0:02:47;75;44951
645;117;111;94,87;6;0:00:18;0:02:43;0:02:06;76,52;44951
646;113;105;92,92;8;0:00:31;0:02:37;0:03:40;53,98;44951
647;107;101;94,39;6;0:00:23;0:02:44;0:03:11;73,58;44951
648;146;141;96,58;5;0:00:25;0:02:22;0:02:46;65,75;44951
649;29;26;89,66;3;0:00:09;0:02:37;0:01:50;85,71;44951
650;231;228;98,7;3;0:00:15;0:02:09;0:03:26;81,39;44951
651;239;215;89,96;24;0:00:23;0:02:36;0:04:35;66,67;44952
652;174;154;88,51;20;0:00:29;0:02:40;0:05:08;61,31;44952
653;168;163;97,02;5;0:00:21;0:02:49;0:02:45;70,66;44952
654;135;128;94,81;7;0:00:18;0:02:36;0:05:30;72,59;44952
655;122;113;92,62;9;0:00:30;0:02:49;0:03:40;61,16;44952
656;13;12;92,31;1;0:00:24;0:02:45;0:01:12;66,67;44952
657;20;18;90;2;0:00:23;0:02:43;0:02:44;73,68;44952
658;152;141;92,76;11;0:00:22;0:02:41;0:04:29;70;44952
659;132;131;99,24;1;0:00:12;0:02:39;0:02:00;87,02;44952
660;180;171;95;9;0:00:21;0:02:51;0:02:39;71,91;44952
661;193;189;97,93;4;0:00:13;0:02:35;0:02:26;82,9;44952
662;245;236;96,33;9;0:00:13;0:02:44;0:02:20;82,79;44952
663;35;34;97,14;1;0:00:11;0:02:11;0:01:44;88,24;44952
664;198;190;95,96;8;0:00:12;0:02:38;0:01:22;84,69;44952
665;47;47;100;0;0:00:06;0:02:09;0:00:57;93,62;44952
666;187;186;99,47;1;0:00:07;0:02:30;0:02:45;93,58;44952
667;57;54;94,74;3;0:00:07;0:02:37;0:00:55;91,07;44952
668;169;162;95,86;7;0:00:09;0:02:39;0:01:50;88,17;44952
669;337;316;93,77;21;0:00:23;0:02:13;0:05:17;72,92;44952
670;44;43;97,73;1;0:00:09;0:02:35;0:01:50;84,09;44952
671;210;206;98,1;4;0:00:12;0:02:39;0:02:32;87,08;44952
672;190;186;97,89;4;0:00:17;0:02:22;0:04:53;84,13;44952
673;190;182;95,79;8;0:00:10;0:02:40;0:01:38;87,03;44952
674;169;168;99,41;1;0:00:11;0:02:25;0:01:48;88,17;44952
675;52;50;96,15;2;0:00:06;0:02:34;0:00:58;92,16;44952
676;144;137;95,14;7;0:00:14;0:02:36;0:02:56;77,08;44952
677;36;36;100;0;0:00:15;0:02:53;0:01:41;80,56;44953
678;155;148;95,48;7;0:00:14;0:02:26;0:03:23;81,29;44953
679;159;154;96,86;5;0:00:16;0:02:41;0:02:12;78,62;44953
680;115;110;95,65;5;0:00:14;0:02:28;0:02:17;83,19;44953
681;186;173;93,01;13;0:00:19;0:02:39;0:02:44;73,51;44953
682;167;157;94,01;10;0:00:23;0:02:32;0:02:49;67,68;44953
683;146;142;97,26;4;0:00:22;0:02:42;0:01:59;66,9;44953
684;41;31;75,61;10;0:00:39;0:03:43;0:03:40;48,78;44953
685;185;85;45,95;100;0:01:49;0:02:46;0:11:01;3,8;44953
686;149;83;55,7;66;0:01:38;0:02:18;0:10:06;4,83;44953
687;180;115;63,89;65;0:01:04;0:02:33;0:12:50;23,86;44953
688;173;144;83,24;29;0:00:38;0:03:00;0:05:32;46,47;44953
689;176;158;89,77;18;0:00:20;0:02:33;0:05:15;70,35;44953
690;147;120;81,63;27;0:00:46;0:02:39;0:04:16;39,73;44953
691;84;77;91,67;7;0:00:17;0:02:07;0:04:30;73,49;44953
692;325;78;24;247;0:03:13;0:03:01;0:17:27;0;44953
693;441;103;23,36;338;0:04:04;0:02:43;0:15:38;0,23;44953
694;525;116;22,1;409;0:05:08;0:03:08;0:22:56;0;44953
695;610;201;32,95;409;0:03:13;0:02:52;0:19:15;3,52;44953
696;427;282;66,04;145;0:01:02;0:02:49;0:14:42;24,88;44953
697;378;331;87,57;47;0:00:43;0:02:37;0:05:30;40,33;44953
698;80;67;83,75;13;0:00:38;0:03:12;0:05:30;46,25;44953
699;356;320;89,89;36;0:00:34;0:02:52;0:05:30;52,56;44953
700;409;355;86,8;54;0:00:44;0:02:55;0:04:21;39,7;44953
701;352;302;85,8;50;0:00:41;0:03:03;0:05:49;47,4;44953
702;282;239;84,75;43;0:00:39;0:03:06;0:08:26;51,07;44953
703;429;390;90,91;39;0:00:38;0:02:41;0:03:40;44,66;44954
704;310;285;91,94;25;0:00:33;0:02:45;0:04:12;56,11;44954
705;102;94;92,16;8;0:00:29;0:02:40;0:02:48;63,73;44954
706;335;297;88,66;38;0:00:39;0:02:33;0:03:42;43,64;44954
707;313;291;92,97;22;0:00:26;0:02:25;0:03:42;64,29;44954
708;251;240;95,62;11;0:00:24;0:02:42;0:02:45;67,2;44954
709;190;176;92,63;14;0:00:24;0:02:31;0:03:53;67,72;44954
710;188;170;90,43;18;0:00:34;0:02:49;0:06:25;53,23;44954
711;166;160;96,39;6;0:00:15;0:02:40;0:02:45;81,82;44954
712;73;68;93,15;5;0:00:15;0:02:13;0:02:28;78,87;44954
713;170;159;93,53;11;0:00:20;0:02:40;0:04:51;73,21;44954
714;188;181;96,28;7;0:00:23;0:02:39;0:03:01;68,28;44954
715;306;262;85,62;44;0:00:44;0:02:48;0:07:37;46,33;44954
716;201;185;92,04;16;0:00:23;0:02:38;0:02:46;67,34;44954
717;188;184;97,87;4;0:00:17;0:02:36;0:02:22;79,26;44954
718;148;131;88,51;17;0:00:31;0:02:51;0:03:36;53,06;44954
719;21;17;80,95;4;0:00:52;0:03:29;0:11:00;52,38;44954
720;148;129;87,16;19;0:00:40;0:03:01;0:06:56;45,52;44954
721;167;154;92,22;13;0:00:17;0:02:43;0:02:49;73,49;44954
722;169;158;93,49;11;0:00:16;0:02:36;0:01:44;75;44954
723;175;163;93,14;12;0:00:22;0:02:37;0:02:18;71,1;44954
724;193;183;94,82;10;0:00:16;0:02:49;0:02:48;80,21;44954
725;154;144;93,51;10;0:00:20;0:02:41;0:02:54;73,51;44954
726;35;34;97,14;1;0:00:14;0:03:06;0:00:58;77,14;44954
727;172;161;93,6;11;0:00:20;0:02:48;0:02:32;72,09;44954
728;195;182;93,33;13;0:00:24;0:02:51;0:03:10;66,84;44954
729;163;157;96,32;6;0:00:17;0:02:46;0:05:33;82,21;44955
730;134;126;94,03;8;0:00:30;0:02:58;0:04:59;63,57;44955
731;158;142;89,87;16;0:00:25;0:02:45;0:02:56;59,35;44955
732;161;144;89,44;17;0:00:34;0:02:49;0:05:00;53,13;44955
733;36;34;94,44;2;0:00:20;0:02:05;0:01:57;72,22;44955
734;147;136;92,52;11;0:00:17;0:02:55;0:03:15;76,71;44955
735;131;130;99,24;1;0:00:18;0:02:47;0:03:18;76,92;44955
736;128;120;93,75;8;0:00:22;0:02:47;0:01:54;68,25;44955
737;136;119;87,5;17;0:00:26;0:02:52;0:04:35;60,15;44955
738;225;209;92,89;16;0:00:19;0:02:29;0:04:06;76,02;44955
739;167;151;90,42;16;0:00:19;0:02:27;0:02:44;73,33;44955
740;48;46;95,83;2;0:00:16;0:02:26;0:02:38;78,72;44955
741;232;204;87,93;28;0:00:32;0:02:22;0:03:56;55,41;44955
742;198;187;94,44;11;0:00:27;0:02:48;0:03:13;60,2;44955
743;171;163;95,32;8;0:00:19;0:02:41;0:02:48;69,41;44955
744;180;173;96,11;7;0:00:31;0:02:49;0:08:13;72,22;44955
745;192;175;91,15;17;0:00:26;0:03:01;0:03:40;61,58;44955
746;194;180;92,78;14;0:00:25;0:02:50;0:04:03;68,39;44955
747;37;27;72,97;10;0:00:35;0:02:53;0:02:58;50;44955
748;180;169;93,89;11;0:00:23;0:02:44;0:02:05;67,98;44955
749;213;198;92,96;15;0:00:16;0:02:47;0:06:21;77,25;44955
750;251;239;95,22;12;0:00:21;0:02:18;0:02:48;71,77;44955
751;200;189;94,5;11;0:00:19;0:02:53;0:04:36;76,26;44955
752;214;205;95,79;9;0:00:25;0:02:48;0:07:17;71,96;44955
753;185;154;83,24;31;0:00:47;0:02:56;0:03:16;35,91;44955
754;49;46;93,88;3;0:00:38;0:02:21;0:02:16;52,08;44955
755;193;185;95,85;8;0:00:21;0:02:51;0:03:57;75,79;44956
756;195;184;94,36;11;0:00:22;0:02:39;0:02:38;70;44956
757;211;195;92,42;16;0:00:34;0:02:51;0:04:31;56,94;44956
758;200;190;95;10;0:00:15;0:02:56;0:03:06;80,93;44956
759;48;47;97,92;1;0:00:15;0:03:13;0:02:58;81,25;44956
760;164;159;96,95;5;0:00:20;0:02:51;0:04:47;77,78;44956
761;43;42;97,67;1;0:00:14;0:02:32;0:02:34;83,72;44956
762;236;223;94,49;13;0:00:26;0:02:46;0:03:38;64,83;44956
763;270;262;97,04;8;0:00:15;0:02:36;0:02:08;83,21;44956
764;304;262;86,18;42;0:00:34;0:02:56;0:07:01;56,62;44956
765;286;270;94,41;16;0:00:20;0:02:48;0:03:06;71,48;44956
766;317;284;89,59;33;0:00:30;0:02:48;0:08:16;66,03;44956
767;471;396;84,08;75;0:00:59;0:02:41;0:05:29;30,8;44956
768;48;44;91,67;4;0:00:29;0:02:31;0:03:07;65,96;44956
769;375;317;84,53;58;0:00:43;0:02:52;0:05:06;40,87;44956
770;327;309;94,5;18;0:00:22;0:02:48;0:03:46;68,21;44956
771;366;316;86,34;50;0:00:37;0:02:44;0:05:11;53,74;44956
772;121;105;86,78;16;0:00:47;0:03:00;0:08:41;60;44956
773;287;266;92,68;21;0:00:34;0:03:06;0:04:08;59,72;44956
774;298;277;92,95;21;0:00:39;0:03:08;0:03:35;51,18;44956
775;70;56;80;14;0:00:46;0:03:23;0:05:08;45,71;44956
776;287;255;88,85;32;0:00:40;0:03:30;0:04:09;46,81;44956
777;298;259;86,91;39;0:00:30;0:03:14;0:07:15;57,97;44956
778;347;317;91,35;30;0:00:30;0:03:11;0:05:52;59,77;44956
779;414;356;85,99;58;0:00:43;0:03:27;0:15:32;47,15;44956
780;406;362;89,16;44;0:00:37;0:03:02;0:05:17;53,48;44956
781;366;322;87,98;44;0:00:35;0:03:03;0:11:12;57,06;44957
782;68;64;94,12;4;0:00:14;0:02:58;0:02:04;82,35;44957
783;350;320;91,43;30;0:00:37;0:03:13;0:05:39;54,18;44957
784;437;352;80,55;85;0:00:52;0:03:01;0:09:33;41,26;44957
785;484;438;90,5;46;0:00:45;0:02:57;0:05:47;44,79;44957
786;405;368;90,86;37;0:00:35;0:03:09;0:05:41;58,1;44957
787;570;368;64,56;202;0:01:11;0:03:24;0:25:51;23,54;44957
788;424;384;90,57;40;0:00:49;0:03:14;0:08:56;39,52;44957
789;60;57;95;3;0:00:32;0:03:19;0:03:00;55,93;44957
790;497;442;88,93;55;0:00:48;0:01:36;0:10:45;57,58;44957
791;429;378;88,11;51;0:00:37;0:02:05;0:10:55;55,29;44957
792;499;388;77,76;111;0:00:54;0:02:15;0:16:59;47,76;44957
793;510;434;85,1;76;0:00:48;0:03:29;0:10:21;42,19;44957
794;549;458;83,42;91;0:01:13;0:03:35;0:09:12;29,07;44957
795;590;444;75,25;146;0:01:23;0:03:34;0:08:58;19,03;44957
796;137;120;87,59;17;0:00:58;0:03:11;0:05:22;33,09;44957
797;598;476;79,6;122;0:00:58;0:03:39;0:08:45;32,03;44957
798;231;180;77,92;51;0:01:04;0:03:33;0:09:07;33,78;44957
799;724;362;50;362;0:02:01;0:03:55;0:12:18;11,66;44957
800;732;367;50,14;365;0:02:48;0:02:52;0:16:38;8,09;44957
801;582;301;51,72;281;0:02:41;0:04:13;0:21:42;12,08;44957
802;621;344;55,39;277;0:02:07;0:03:29;0:12:24;14,47;44957
803;116;106;91,38;10;0:00:34;0:04:23;0:04:44;62,93;44957
804;533;300;56,29;233;0:02:12;0:04:03;0:12:24;12,55;44957
805;416;322;77,4;94;0:01:04;0:03:34;0:06:12;38,59;44957
806;415;259;62,41;156;0:02:10;0:03:57;0:13:38;17,89;44957
807;433;289;66,74;144;0:01:42;0:03:28;0:13:12;22,95;44958
808;454;284;62,56;170;0:01:53;0:03:34;0:19:22;24,44;44958
809;244;195;79,92;49;0:01:25;0:03:51;0:11:22;36,67;44958
810;51;48;94,12;3;0:00:14;0:03:26;0:03:21;84,31;44958
811;202;176;87,13;26;0:00:24;0:03:42;0:05:28;67,16;44958
812;128;118;92,19;10;0:00:30;0:03:42;0:07:53;74,02;44958
813;102;100;98,04;2;0:00:14;0:03:32;0:03:09;85,29;44958
814;201;169;84,08;32;0:00:32;0:03:25;0:06:12;58,08;44958
815;261;195;74,71;66;0:01:01;0:03:27;0:07:55;37,98;44958
816;201;173;86,07;28;0:00:41;0:03:15;0:06:50;59,5;44958
817;64;61;95,31;3;0:00:09;0:03:15;0:02:23;92,06;44958
818;200;168;84;32;0:00:51;0:03:23;0:06:46;48,74;44958
819;158;148;93,67;10;0:00:30;0:03:17;0:04:08;56,69;44958
820;174;155;89,08;19;0:00:26;0:03:01;0:05:10;62,35;44958
821;67;64;95,52;3;0:00:26;0:03:31;0:04:58;71,21;44958
822;24;23;95,83;1;0:00:23;0:02:50;0:02:01;75;44958
823;106;92;86,79;14;0:00:44;0:03:03;0:05:04;45,63;44958
824;52;50;96,15;2;0:00:11;0:03:19;0:01:24;88,46;44958
825;223;203;91,03;20;0:00:31;0:03:18;0:04:11;62,1;44958
826;274;233;85,04;41;0:00:48;0:03:27;0:05:10;36,06;44958
827;280;263;93,93;17;0:00:23;0:03:13;0:03:50;67,64;44958
828;534;468;87,64;66;0:00:30;0:02:46;0:04:39;57,47;44958
829;315;300;95,24;15;0:00:24;0:03:11;0:02:50;70,23;44958
830;122;113;92,62;9;0:00:20;0:02:58;0:02:19;76,67;44958
831;63;60;95,24;3;0:00:21;0:02:51;0:02:52;74,19;44958
832;402;368;91,54;34;0:00:32;0:03:07;0:03:06;54,18;44958
833;413;370;89,59;43;0:00:29;0:03:10;0:03:22;58,42;44959
834;389;346;88,95;43;0:00:36;0:03:21;0:05:10;49,87;44959
835;495;308;62,22;187;0:01:31;0:03:25;0:16:35;18,56;44959
836;712;340;47,75;372;0:02:00;0:03:26;0:16:25;12,26;44959
837;1057;602;56,95;455;0:01:44;0:02:33;0:12:24;11,49;44959
838;620;321;51,77;299;0:02:42;0:03:13;0:16:34;10,87;44959
839;1575;871;55,3;704;0:01:32;0:02:33;0:22:45;13,93;44959
840;1349;775;57,45;574;0:01:46;0:03:10;0:15:53;12,16;44959
841;999;454;45,45;545;0:02:48;0:03:14;0:13:24;4,07;44959
842;968;547;56,51;421;0:02:26;0:03:18;0:14:13;11,71;44959
843;1066;453;42,5;613;0:05:04;0:03:39;0:22:37;2,24;44959
844;788;633;80,33;155;0:01:13;0:03:23;0:12:26;20,88;44959
845;252;213;84,52;39;0:00:53;0:03:31;0:08:17;44,08;44959
846;842;625;74,23;217;0:01:11;0:03:10;0:14:28;26,93;44959
847;847;722;85,24;125;0:00:54;0:03:04;0:08:05;33,49;44959
848;800;615;76,88;185;0:01:07;0:03:25;0:07:24;23,98;44959
849;1100;823;74,82;277;0:01:08;0:03:18;0:15:31;29,65;44959
850;1242;909;73,19;333;0:01:23;0:03:04;0:11:11;19;44959
851;732;460;62,84;272;0:01:31;0:03:12;0:10:29;17,92;44959
852;112;104;92,86;8;0:00:34;0:03:21;0:04:13;56,36;44959
853;482;434;90,04;48;0:00:41;0:03:01;0:11:01;47,44;44959
854;570;484;84,91;86;0:00:51;0:03:07;0:11:48;36,9;44959
855;490;398;81,22;92;0:00:50;0:03:17;0:21:44;36,1;44959
856;462;311;67,32;151;0:01:11;0:03:17;0:08:50;26,34;44959
857;428;373;87,15;55;0:00:40;0:02:58;0:07:01;50,6;44959
858;393;312;79,39;81;0:01:02;0:03:16;0:08:16;31,4;44959
859;58;50;86,21;8;0:00:29;0:03:04;0:03:06;67,24;44960
860;316;279;88,29;37;0:00:40;0:02:58;0:03:31;44,16;44960
861;298;274;91,95;24;0:00:30;0:02:59;0:03:02;55,78;44960
862;308;275;89,29;33;0:00:40;0:02:56;0:06:54;51,63;44960
863;259;242;93,44;17;0:00:16;0:02:54;0:04:09;78,26;44960
864;464;391;84,27;73;0:00:55;0:03:31;0:05:13;35,45;44960
865;302;275;91,06;27;0:00:30;0:03:02;0:09:54;56,04;44960
866;47;45;95,74;2;0:00:12;0:02:41;0:02:37;85,11;44960
867;293;279;95,22;14;0:00:22;0:02:53;0:02:57;67,47;44960
868;245;225;91,84;20;0:00:18;0:02:55;0:04:11;73,55;44960
869;295;227;76,95;68;0:00:48;0:03:19;0:05:42;44,79;44960
870;205;196;95,61;9;0:00:20;0:03:06;0:05:10;73,66;44960
871;249;215;86,35;34;0:00:40;0:02:58;0:24:51;46,09;44960
872;236;213;90,25;23;0:00:26;0:03:14;0:03:54;63,36;44960
873;39;39;100;0;0:00:14;0:02:30;0:02:27;87,18;44960
874;208;194;93,27;14;0:00:17;0:02:54;0:02:59;76,96;44960
875;39;38;97,44;1;0:00:04;0:02:21;0:01:02;94,87;44960
876;115;110;95,65;5;0:00:08;0:02:46;0:04:12;90,43;44960
877;338;308;91,12;30;0:00:27;0:02:50;0:04:11;63,1;44960
878;404;320;79,21;84;0:00:45;0:02:58;0:11:53;51,39;44960
879;436;393;90,14;43;0:00:26;0:02:51;0:06:13;65,26;44960
880;73;72;98,63;1;0:00:07;0:02:46;0:01:43;93,15;44960
881;521;492;94,43;29;0:00:17;0:02:45;0:03:23;78,94;44960
882;648;564;87,04;84;0:00:27;0:02:46;0:05:25;61,36;44960
883;729;592;81,21;137;0:00:55;0:02:53;0:07:29;35,83;44960
884;1196;718;60,03;478;0:01:52;0:03:09;0:11:06;14,62;44960
885;436;323;74,08;113;0:00:44;0:03:02;0:06:12;43,75;44961
886;191;178;93,19;13;0:00:16;0:02:51;0:04:08;80,53;44961
887;68;68;100;0;0:00:05;0:02:56;0:01:39;98,53;44961
888;498;429;86,14;69;0:00:34;0:03:09;0:04:12;50,71;44961
889;358;329;91,9;29;0:00:21;0:03:03;0:02:15;66,95;44961
890;340;302;88,82;38;0:00:24;0:02:50;0:05:10;65,67;44961
891;322;306;95,03;16;0:00:16;0:02:39;0:06:17;77,74;44961
892;296;282;95,27;14;0:00:18;0:02:37;0:02:45;76,53;44961
893;264;234;88,64;30;0:00:20;0:02:34;0:04:54;69,88;44961
894;52;51;98,08;1;0:00:06;0:02:36;0:01:05;94,12;44961
895;266;264;99,25;2;0:00:09;0:02:39;0:02:01;90,98;44961
896;242;238;98,35;4;0:00:09;0:02:45;0:02:30;90,46;44961
897;241;228;94,61;13;0:00:19;0:02:48;0:06:08;79,58;44961
898;279;269;96,42;10;0:00:08;0:02:43;0:03:07;91,3;44961
899;73;72;98,63;1;0:00:08;0:03:04;0:02:10;91,78;44961
900;226;218;96,46;8;0:00:08;0:02:54;0:02:47;91,86;44961
901;43;42;97,67;1;0:00:11;0:02:38;0:01:17;83,72;44961
902;311;255;81,99;56;0:00:45;0:02:55;0:04:50;47,18;44961
903;251;210;83,67;41;0:00:26;0:02:54;0:09:18;63,52;44961
904;339;313;92,33;26;0:00:12;0:02:02;0:06:41;82,09;44961
905;323;261;80,8;62;0:00:41;0:02:57;0:09:27;53,99;44961
906;289;265;91,7;24;0:00:11;0:03:00;0:05:42;83,27;44961
907;310;281;90,65;29;0:00:15;0:02:41;0:02:57;79,12;44961
908;33;31;93,94;2;0:00:14;0:02:53;0:02:07;84,85;44961
909;346;318;91,91;28;0:00:12;0:02:36;0:03:32;82,49;44961
910;325;285;87,69;40;0:00:32;0:02:45;0:09:39;60,82;44961
911;627;504;80,38;123;0:00:37;0:03:20;0:19:42;56,93;44962
912;905;631;69,72;274;0:01:23;0:03:42;0:12:04;25,68;44962
913;1141;610;53,46;531;0:01:46;0:03:12;0:25:51;14,55;44962
914;863;511;59,21;352;0:02:07;0:03:03;0:15:43;12,13;44962
915;63;56;88,89;7;0:00:16;0:02:31;0:04:08;70,97;44962
916;573;487;84,99;86;0:00:56;0:02:45;0:05:43;34,99;44962
917;391;323;82,61;68;0:00:46;0:03:08;0:08:16;42,71;44962
918;526;355;67,49;171;0:01:29;0:03:50;0:18:47;22,4;44962
919;343;309;90,09;34;0:00:39;0:03:24;0:05:10;48,82;44962
920;401;346;86,28;55;0:00:41;0:03:13;0:05:10;44,27;44962
921;281;239;85,05;42;0:00:41;0:03:07;0:03:20;42,55;44962
922;46;39;84,78;7;0:00:11;0:03:09;0:04:09;80,43;44962
923;357;323;90,48;34;0:00:32;0:03:08;0:07:14;60,91;44962
924;280;255;91,07;25;0:00:34;0:03:02;0:03:31;52,9;44962
925;258;247;95,74;11;0:00:25;0:02:57;0:04:12;70,2;44962
926;282;255;90,43;27;0:00:18;0:02:47;0:04:09;74,73;44962
927;253;240;94,86;13;0:00:18;0:02:41;0:06:11;75,2;44962
928;266;232;87,22;34;0:00:37;0:02:49;0:06:11;57,59;44962
929;30;29;96,67;1;0:00:10;0:03:21;0:00:49;90;44962
930;258;230;89,15;28;0:00:33;0:03:01;0:04:14;53,54;44962
931;293;282;96,25;11;0:00:23;0:02:39;0:02:38;70,24;44962
932;377;341;90,45;36;0:00:20;0:02:21;0:03:09;68,28;44962
933;196;182;92,86;14;0:00:28;0:02:37;0:02:54;61,86;44962
934;192;173;90,1;19;0:00:33;0:02:44;0:06:39;61,78;44962
935;185;178;96,22;7;0:00:17;0:02:46;0:03:09;77,72;44962
936;27;25;92,59;2;0:00:18;0:02:09;0:03:07;74,07;44962
937;222;214;96,4;8;0:00:18;0:02:57;0:06:12;74,66;44963
938;217;198;91,24;19;0:00:09;0:02:43;0:02:57;88,83;44963
939;204;197;96,57;7;0:00:17;0:02:40;0:03:50;79,7;44963
940;191;181;94,76;10;0:00:12;0:02:46;0:04:44;87,23;44963
941;176;157;89,2;19;0:00:17;0:02:51;0:04:08;73,53;44963
942;176;163;92,61;13;0:00:24;0:03:11;0:03:07;64,16;44963
943;26;26;100;0;0:00:24;0:03:03;0:01:57;69,23;44963
944;170;167;98,24;3;0:00:16;0:02:47;0:02:08;79,41;44963
945;154;147;95,45;7;0:00:21;0:03:02;0:03:47;75,16;44963
946;165;152;92,12;13;0:00:17;0:02:58;0:03:40;80,75;44963
947;153;143;93,46;10;0:00:19;0:03:05;0:03:15;77,63;44963
948;175;169;96,57;6;0:00:11;0:02:17;0:02:12;85,63;44963
949;241;214;88,8;27;0:00:29;0:03:00;0:14:33;66,23;44963
950;14;14;100;0;0:00:16;0:02:46;0:01:27;85,71;44963
951;57;55;96,49;2;0:00:12;0:02:35;0:02:07;85,96;44963
952;954;644;67,51;310;0:01:14;0:02:05;0:11:12;26,33;44963
953;374;344;91,98;30;0:00:28;0:03:03;0:08:52;61,85;44963
954;265;245;92,45;20;0:00:31;0:03:05;0:03:21;56,7;44963
955;222;205;92,34;17;0:00:20;0:03:12;0:02:10;72,69;44963
956;203;192;94,58;11;0:00:27;0:03:04;0:04:07;68,66;44963
957;33;31;93,94;2;0:00:29;0:02:15;0:05:43;78,13;44963
958;220;195;88,64;25;0:00:28;0:02:45;0:03:06;59,62;44963
959;185;177;95,68;8;0:00:16;0:02:33;0:03:08;80,11;44963
960;203;172;84,73;31;0:00:34;0:02:53;0:05:06;52,79;44963
961;218;193;88,53;25;0:00:34;0:02:58;0:07:34;61,97;44963
962;204;194;95,1;10;0:00:16;0:02:52;0:03:06;81,31;44963
963;242;211;87,19;31;0:00:44;0:02:57;0:06:08;47,7;44964
964;29;29;100;0;0:00:08;0:02:40;0:00:44;89,66;44964
965;171;163;95,32;8;0:00:24;0:02:58;0:03:19;69,23;44964
966;190;166;87,37;24;0:00:46;0:02:59;0:09:20;42,25;44964
967;221;196;88,69;25;0:00:33;0:02:57;0:05:25;53,67;44964
968;297;241;81,14;56;0:00:49;0:03:11;0:06:52;44,83;44964
969;233;214;91,85;19;0:00:26;0:02:49;0:03:53;62,5;44964
970;198;191;96,46;7;0:00:14;0:03:01;0:02:09;82,74;44964
971;15;15;100;0;0:00:04;0:03:19;0:00:14;100;44964
972;27;25;92,59;2;0:00:08;0:02:34;0:02:04;88,89;44964
973;7;6;85,71;1;0:00:03;0:04:48;0:00:31;85,71;44964
974;169;144;85,21;25;0:00:33;0:02:36;0:08:31;56,36;44964
975;224;206;91,96;18;0:00:20;0:02:35;0:02:26;70,72;44964
976;170;160;94,12;10;0:00:28;0:03:01;0:05:10;62,35;44964
977;161;149;92,55;12;0:00:24;0:03:08;0:02:34;68,13;44964
978;37;35;94,59;2;0:00:12;0:02:48;0:01:03;80,56;44964
979;183;169;92,35;14;0:00:32;0:02:58;0:04:28;59,89;44964
980;221;206;93,21;15;0:00:30;0:02:54;0:04:23;58,18;44964
981;202;193;95,54;9;0:00:18;0:02:53;0:02:48;75,38;44964
982;193;163;84,46;30;0:00:36;0:03:12;0:05:12;53,4;44964
983;201;196;97,51;5;0:00:10;0:02:43;0:02:32;89;44964
984;193;180;93,26;13;0:00:21;0:02:42;0:03:17;73,16;44964
985;27;25;92,59;2;0:00:25;0:02:03;0:02:07;66,67;44964
986;227;206;90,75;21;0:00:29;0:03:01;0:04:26;66,67;44964
987;225;199;88,44;26;0:00:35;0:02:58;0:05:19;52,68;44964
988;204;193;94,61;11;0:00:33;0:02:39;0:05:21;58,82;44964
989;221;194;87,78;27;0:00:29;0:02:48;0:05:05;60,73;44965
990;172;154;89,53;18;0:00:34;0:03:09;0:03:06;54,17;44965
991;161;150;93,17;11;0:00:36;0:02:51;0:05:53;52,8;44965
992;17;14;82,35;3;0:00:47;0:03:08;0:02:52;41,18;44965
993;168;145;86,31;23;0:00:38;0:02:57;0:04:08;50,61;44965
994;160;142;88,75;18;0:00:33;0:02:44;0:09:18;54,14;44965
995;185;159;85,95;26;0:00:41;0:02:56;0:05:43;42,7;44965
996;155;146;94,19;9;0:00:28;0:02:49;0:03:27;65,16;44965
997;188;172;91,49;16;0:00:28;0:02:39;0:03:04;59,78;44965
998;152;120;78,95;32;0:00:29;0:02:54;0:06:35;53,06;44965
999;26;26;100;0;0:00:17;0:03:01;0:01:18;80,77;44965
1000;152;140;92,11;12;0:00:21;0:02:58;0:06:40;70,67;44965
1001;130;125;96,15;5;0:00:08;0:02:39;0:01:02;92;44965
1002;191;187;97,91;4;0:00:18;0:02:33;0:02:53;83,07;44965
1003;254;227;89,37;27;0:00:33;0:02:57;0:04:35;56,57;44965
1004;213;188;88,26;25;0:00:30;0:02:52;0:05:10;54,81;44965
1005;176;151;85,8;25;0:00:32;0:02:45;0:06:12;55,75;44965
1006;61;59;96,72;2;0:00:16;0:01:31;0:03:06;80,33;44965
1007;166;154;92,77;12;0:00:28;0:02:56;0:03:16;61,82;44965
1008;191;172;90,05;19;0:00:21;0:02:40;0:03:23;73,77;44965
1009;171;157;91,81;14;0:00:19;0:02:34;0:02:07;72,62;44965
1010;153;124;81,05;29;0:00:50;0:03:04;0:06:01;45,33;44965
1011;183;158;86,34;25;0:00:33;0:02:52;0:05:10;51,91;44965
1012;14;14;100;0;0:00:15;0:03:43;0:01:32;85,71;44965
1013;18;18;100;0;0:00:03;0:02:56;0:00:06;100;44965
1014;159;148;93,08;11;0:00:22;0:02:36;0:03:15;69,43;44965
1015;143;134;93,71;9;0:00:22;0:02:51;0:05:10;74,1;44966
1016;195;175;89,74;20;0:00:29;0:02:47;0:04:11;61,58;44966
1017;194;150;77,32;44;0:00:37;0:02:47;0:04:17;47,34;44966
1018;390;362;92,82;28;0:00:31;0:02:50;0:05:46;59,48;44966
1019;238;205;86,13;33;0:00:29;0:02:18;0:05:10;60,87;44966
1020;29;28;96,55;1;0:00:09;0:02:28;0:01:05;89,29;44966
1021;30;29;96,67;1;0:00:19;0:02:30;0:02:31;83,33;44966
1022;287;273;95,12;14;0:00:16;0:02:20;0:03:06;79;44966
1023;474;380;80,17;94;0:00:39;0:02:08;0:07:58;47,42;44966
1024;277;230;83,03;47;0:00:40;0:02:52;0:06:13;46,18;44966
1025;173;163;94,22;10;0:00:17;0:02:46;0:02:44;77,19;44966
1026;167;152;91,02;15;0:00:13;0:02:37;0:05:10;84,15;44966
1027;27;24;88,89;3;0:00:20;0:02:05;0:03:43;76,92;44966
1028;173;153;88,44;20;0:00:29;0:02:46;0:03:06;57,99;44966
1029;36;27;75;9;0:00:36;0:02:55;0:03:57;41,67;44966
1030;186;171;91,94;15;0:00:27;0:02:49;0:03:28;64,48;44966
1031;160;149;93,13;11;0:00:23;0:02:47;0:04:52;74,05;44966
1032;233;215;92,27;18;0:00:22;0:02:34;0:08:08;74,12;44966
1033;162;157;96,91;5;0:00:13;0:02:32;0:05:10;82,72;44966
1034;27;24;88,89;3;0:00:18;0:02:10;0:03:51;70,37;44966
1035;168;155;92,26;13;0:00:26;0:03:18;0:03:08;64,88;44966
1036;328;301;91,77;27;0:00:23;0:02:29;0:06:59;67,91;44966
1037;234;208;88,89;26;0:00:20;0:02:44;0:05:18;72,25;44966
1038;37;34;91,89;3;0:00:14;0:02:16;0:03:44;83,78;44966
1039;185;167;90,27;18;0:00:18;0:02:43;0:06:12;73,51;44966
1040;139;132;94,96;7;0:00:10;0:02:57;0:03:28;88,32;44966
1041;13;11;84,62;2;0:00:46;0:02:07;0:02:35;41,67;44967
1042;161;152;94,41;9;0:00:23;0:02:28;0:02:52;69,62;44967
1043;149;144;96,64;5;0:00:15;0:02:46;0:03:01;83,11;44967
1044;178;167;93,82;11;0:00:22;0:02:42;0:05:24;74,86;44967
1045;224;210;93,75;14;0:00:21;0:03:00;0:04:47;72,52;44967
1046;277;273;98,56;4;0:00:10;0:02:00;0:02:03;89,74;44967
1047;188;172;91,49;16;0:00:20;0:02:41;0:03:36;72,19;44967
1048;26;22;84,62;4;0:00:34;0:02:23;0:06:18;68;44967
1049;177;167;94,35;10;0:00:35;0:02:56;0:03:15;56,25;44967
1050;149;144;96,64;5;0:00:28;0:02:47;0:03:48;66,22;44967
1051;147;147;100;0;0:00:11;0:02:51;0:02:03;85,71;44967
1052;140;134;95,71;6;0:00:19;0:02:44;0:08:19;78,57;44967
1053;177;163;92,09;14;0:00:19;0:02:35;0:07:16;75,71;44967
1054;169;169;100;0;0:00:09;0:02:45;0:01:05;89,94;44967
1055;26;21;80,77;5;0:00:27;0:02:28;0:02:04;48;44967
1056;147;140;95,24;7;0:00:12;0:02:48;0:02:11;85,52;44967
1057;127;122;96,06;5;0:00:21;0:02:48;0:02:07;70,87;44967
1058;141;135;95,74;6;0:00:17;0:02:27;0:04:08;78,01;44967
1059;208;181;87,02;27;0:00:38;0:02:39;0:04:08;49,02;44967
1060;178;163;91,57;15;0:00:33;0:02:54;0:04:58;54,8;44967
1061;198;190;95,96;8;0:00:25;0:02:32;0:02:22;67,01;44967
1062;21;17;80,95;4;0:00:44;0:03:31;0:04:37;47,62;44967
1063;171;161;94,15;10;0:00:16;0:02:35;0:06:14;81,44;44967
1064;200;196;98;4;0:00:09;0:02:51;0:02:01;91,92;44967
1065;166;157;94,58;9;0:00:24;0:02:40;0:01:54;64,63;44967
1066;230;217;94,35;13;0:00:27;0:02:39;0:02:03;57,21;44967
1067;174;168;96,55;6;0:00:24;0:02:57;0:02:54;69,59;44968
1068;240;185;77,08;55;0:01:00;0:03:02;0:05:00;29,79;44968
1069;35;27;77,14;8;0:00:48;0:02:56;0:03:53;43,33;44968
1070;198;179;90,4;19;0:00:27;0:02:41;0:09:40;60,1;44968
1071;189;181;95,77;8;0:00:19;0:02:59;0:02:44;71,43;44968
1072;229;219;95,63;10;0:00:30;0:03:15;0:06:25;59,21;44968
1073;254;235;92,52;19;0:00:27;0:02:56;0:03:52;59,68;44968
1074;584;521;89,21;63;0:00:29;0:02:16;0:04:21;58,3;44968
1075;564;551;97,7;13;0:00:12;0:01:40;0:01:46;83,96;44968
1076;150;149;99,33;1;0:00:10;0:01:40;0:02:11;89,33;44968
1077;521;499;95,78;22;0:00:23;0:01:36;0:03:04;70,93;44968
1078;330;309;93,64;21;0:00:21;0:03:19;0:06:32;69,54;44968
1079;298;288;96,64;10;0:00:13;0:03:20;0:04:03;84,75;44968
1080;294;287;97,62;7;0:00:14;0:03:28;0:03:19;82,25;44968
1081;261;253;96,93;8;0:00:10;0:03:03;0:05:48;89,96;44968
1082;223;210;94,17;13;0:00:16;0:03:07;0:05:23;80,09;44968
1083;59;58;98,31;1;0:00:21;0:03:41;0:03:12;74,58;44968
1084;340;327;96,18;13;0:00:21;0:01:55;0:03:46;77,61;44968
1085;287;280;97,56;7;0:00:13;0:03:05;0:01:56;84,32;44968
1086;269;257;95,54;12;0:00:16;0:03:04;0:03:49;82,02;44968
1087;270;261;96,67;9;0:00:12;0:03:06;0:04:29;85,87;44968
1088;285;273;95,79;12;0:00:12;0:03:14;0:02:53;85,36;44968
1089;251;229;91,24;22;0:00:22;0:02:59;0:03:06;73,06;44968
1090;47;47;100;0;0:00:13;0:03:03;0:01:29;87,23;44968
1091;233;225;96,57;8;0:00:13;0:03:02;0:01:57;84,72;44968
1092;257;248;96,5;9;0:00:14;0:03:14;0:03:42;83,4;44968
1093;245;234;95,51;11;0:00:11;0:03:01;0:01:56;85,95;44969
1094;267;265;99,25;2;0:00:05;0:02:59;0:01:13;97,36;44969
1095;231;224;96,97;7;0:00:11;0:02:56;0:02:54;86,58;44969
1096;236;226;95,76;10;0:00:19;0:03:04;0:03:06;75;44969
1097;81;78;96,3;3;0:00:11;0:02:57;0:00:58;81,25;44969
1098;281;273;97,15;8;0:00:11;0:03:02;0:03:21;88,49;44969
1099;399;387;96,99;12;0:00:11;0:02:51;0:02:25;86,36;44969
1100;291;287;98,63;4;0:00:11;0:02:36;0:03:38;87,97;44969
1101;290;281;96,9;9;0:00:07;0:03:03;0:01:00;91,64;44969
1102;230;227;98,7;3;0:00:08;0:03:06;0:01:12;91,67;44969
1103;236;216;91,53;20;0:00:17;0:03:09;0:02:54;70,69;44969
1104;45;44;97,78;1;0:00:05;0:02:45;0:01:56;93,33;44969
1105;249;238;95,58;11;0:00:11;0:02:42;0:01:58;86,53;44969
1106;350;328;93,71;22;0:00:28;0:02:31;0:02:28;58,26;44969
1107;361;306;84,76;55;0:00:27;0:02:26;0:06:41;60,17;44969
1108;262;256;97,71;6;0:00:13;0:02:50;0:02:54;86,15;44969
1109;302;288;95,36;14;0:00:21;0:02:56;0:02:59;71,1;44969
1110;299;268;89,63;31;0:00:28;0:02:49;0:02:58;55,41;44969
1111;50;49;98;1;0:00:24;0:02:55;0:02:08;76;44969
1112;285;273;95,79;12;0:00:21;0:02:49;0:03:30;76,16;44969
1113;77;75;97,4;2;0:00:09;0:02:43;0:02:10;92,11;44969
1114;332;321;96,69;11;0:00:17;0:02:58;0:03:34;80,66;44969
1115;282;266;94,33;16;0:00:22;0:03:10;0:08:12;74,29;44969
1116;256;248;96,88;8;0:00:14;0:03:00;0:03:52;82,35;44969
1117;177;176;99,44;1;0:00:12;0:02:37;0:01:45;83,52;44969
1118;27;24;88,89;3;0:00:13;0:02:15;0:01:08;74,07;44969
1119;307;305;99,35;2;0:00:09;0:03:01;0:01:42;91,8;44970
1120;587;577;98,3;10;0:00:10;0:02:08;0:01:56;91,94;44970
1121;270;265;98,15;5;0:00:07;0:02:44;0:01:56;91,79;44970
1122;307;297;96,74;10;0:00:14;0:02:59;0:02:55;82,24;44970
1123;242;238;98,35;4;0:00:06;0:02:42;0:01:55;94,63;44970
1124;194;182;93,81;12;0:00:12;0:02:57;0:01:36;81,15;44970
1125;21;21;100;0;0:00:12;0:03:07;0:01:34;90,48;44970
1126;291;288;98,97;3;0:00:07;0:02:46;0:01:24;93,79;44970
1127;516;479;92,83;37;0:00:26;0:02:40;0:03:31;63,8;44970
1128;452;447;98,89;5;0:00:06;0:02:04;0:03:52;94,44;44970
1129;375;375;100;0;0:00:05;0:02:13;0:01:05;96,53;44970
1130;306;287;93,79;19;0:00:19;0:02:15;0:04:50;76,32;44970
1131;241;235;97,51;6;0:00:15;0:02:40;0:01:57;80,33;44970
1132;34;34;100;0;0:00:18;0:03:01;0:02:08;85,29;44970
1133;248;238;95,97;10;0:00:19;0:02:43;0:04:33;74,09;44970
1134;323;307;95,05;16;0:00:13;0:02:42;0:03:28;82,7;44970
1135;260;257;98,85;3;0:00:10;0:02:29;0:01:42;91,12;44970
1136;316;311;98,42;5;0:00:10;0:02:41;0:02:54;87,54;44970
1137;60;59;98,33;1;0:00:03;0:02:41;0:01:55;98,33;44970
1138;267;251;94,01;16;0:00:19;0:02:27;0:07:44;75,56;44970
1139;30;29;96,67;1;0:00:08;0:02:00;0:00:46;93,1;44970
1140;247;238;96,36;9;0:00:13;0:02:35;0:02:54;83,33;44970
1141;376;365;97,07;11;0:00:15;0:03:00;0:03:30;81,77;44970
1142;316;306;96,84;10;0:00:13;0:02:55;0:01:58;82,8;44970
1143;310;304;98,06;6;0:00:07;0:02:51;0:01:40;92,16;44970
1144;340;327;96,18;13;0:00:23;0:02:55;0:02:34;71,34;44970
1145;306;289;94,44;17;0:00:24;0:02:43;0:05:04;69,74;44971
1146;40;40;100;0;0:00:05;0:02:46;0:00:51;97,5;44971
1147;378;370;97,88;8;0:00:11;0:02:52;0:02:36;86,7;44971
1148;424;416;98,11;8;0:00:14;0:02:54;0:03:41;83,89;44971
1149;356;353;99,16;3;0:00:05;0:02:48;0:01:04;97,17;44971
1150;320;308;96,25;12;0:00:10;0:02:33;0:03:24;88,99;44971
1151;351;341;97,15;10;0:00:11;0:02:50;0:01:49;86,25;44971
1152;85;83;97,65;2;0:00:13;0:02:47;0:03:44;85,88;44971
1153;44;43;97,73;1;0:00:09;0:02:33;0:03:52;84,09;44971
1154;388;363;93,56;25;0:00:19;0:03:06;0:02:54;75,2;44971
1155;283;280;98,94;3;0:00:06;0:03:05;0:01:49;95,73;44971
1156;241;238;98,76;3;0:00:05;0:02:55;0:03:16;96,67;44971
1157;280;273;97,5;7;0:00:09;0:02:46;0:03:38;88,21;44971
1158;294;273;92,86;21;0:00:26;0:03:16;0:02:44;61,77;44971
1159;290;246;84,83;44;0:00:27;0:03:04;0:04:44;63,86;44971
1160;32;32;100;0;0:00:06;0:02:43;0:01:10;96,88;44971
1161;270;263;97,41;7;0:00:12;0:02:52;0:02:00;85,45;44971
1162;212;208;98,11;4;0:00:08;0:02:43;0:02:34;91;44971
1163;246;238;96,75;8;0:00:07;0:02:53;0:03:48;91,84;44971
1164;194;190;97,94;4;0:00:08;0:02:43;0:03:34;92,78;44971
1165;179;176;98,32;3;0:00:06;0:02:44;0:01:43;96,05;44971
1166;67;65;97,01;2;0:00:09;0:02:36;0:01:59;89,55;44971
1167;27;27;100;0;0:00:09;0:02:27;0:01:33;88,89;44971
1168;190;183;96,32;7;0:00:09;0:02:38;0:02:54;87,83;44971
1169;213;205;96,24;8;0:00:10;0:02:38;0:05:02;88,15;44971
1170;208;205;98,56;3;0:00:04;0:02:36;0:02:53;97,09;44971
1171;166;165;99,4;1;0:00:08;0:02:41;0:03:31;92,77;44972
1172;169;161;95,27;8;0:00:18;0:02:52;0:03:37;73,96;44972
1173;175;167;95,43;8;0:00:10;0:02:29;0:03:52;86,29;44972
1174;43;43;100;0;0:00:04;0:02:42;0:00:29;100;44972
1175;24;24;100;0;0:00:03;0:02:46;0:00:03;100;44972
1176;26;26;100;0;0:00:05;0:02:52;0:00:58;92,31;44972
1177;42;41;97,62;1;0:00:03;0:02:41;0:00:03;100;44972
1178;37;36;97,3;1;0:00:05;0:02:24;0:04:50;94,59;44972
1179;60;60;100;0;0:00:05;0:03:07;0:01:01;96,67;44972
1180;82;81;98,78;1;0:00:03;0:02:24;0:00:58;97,56;44972
1181;31;31;100;0;0:00:06;0:02:20;0:01:01;93,55;44972
1182;178;171;96,07;7;0:00:16;0:02:43;0:02:06;76,14;44972
1183;183;175;95,63;8;0:00:13;0:02:27;0:04:38;85,56;44972
1184;39;37;94,87;2;0:00:03;0:02:53;0:00:58;97,37;44972
1185;170;167;98,24;3;0:00:12;0:02:24;0:02:50;85,29;44972
1186;180;168;93,33;12;0:00:12;0:02:46;0:04:29;83,15;44972
1187;24;24;100;0;0:00:04;0:02:36;0:00:21;100;44972
1188;7;7;100;0;0:00:33;0:02:39;0:01:33;42,86;44972
1189;181;181;100;0;0:00:12;0:02:47;0:01:29;87,85;44972
1190;209;206;98,56;3;0:00:05;0:02:42;0:00:58;95,17;44972
1191;180;179;99,44;1;0:00:04;0:02:28;0:01:02;97,21;44972
1192;221;203;91,86;18;0:00:12;0:02:43;0:02:55;87,32;44972
1193;254;248;97,64;6;0:00:10;0:02:48;0:03:07;90,87;44972
1194;627;577;92,03;50;0:00:41;0:02:39;0:05:20;47,81;44972
1195;167;159;95,21;8;0:00:18;0:03:10;0:03:55;76,05;44972
1196;599;554;92,49;45;0:00:25;0:02:35;0:04:50;63,56;44972
1197;304;300;98,68;4;0:00:07;0:02:35;0:02:55;92,41;44973
1198;267;260;97,38;7;0:00:08;0:02:56;0:01:54;90,91;44973
1199;286;281;98,25;5;0:00:11;0:02:40;0:02:54;86,97;44973
1200;196;192;97,96;4;0:00:13;0:02:43;0:02:06;85,64;44973
1201;191;189;98,95;2;0:00:11;0:03:00;0:02:34;88,42;44973
1202;60;60;100;0;0:00:06;0:01:58;0:00:59;96,67;44973
1203;215;207;96,28;8;0:00:10;0:02:40;0:01:44;90,43;44973
1204;221;213;96,38;8;0:00:08;0:02:35;0:01:47;90,45;44973
1205;201;193;96,02;8;0:00:03;0:02:46;0:00:58;98,45;44973
1206;205;202;98,54;3;0:00:05;0:02:48;0:01:09;96,06;44973
1207;201;194;96,52;7;0:00:14;0:02:44;0:02:29;84,26;44973
1208;140;132;94,29;8;0:00:07;0:01:51;0:01:56;92,48;44973
1209;29;28;96,55;1;0:00:13;0:03:09;0:01:47;82,76;44973
1210;398;372;93,47;26;0:00:21;0:02:51;0:04:13;72,52;44973
1211;255;249;97,65;6;0:00:15;0:03:01;0:02:09;83,33;44973
1212;283;278;98,23;5;0:00:17;0:02:38;0:01:59;79,57;44973
1213;230;222;96,52;8;0:00:21;0:02:46;0:02:45;72,25;44973
1214;185;183;98,92;2;0:00:10;0:03:15;0:01:20;89,73;44973
1215;197;194;98,48;3;0:00:13;0:02:49;0:02:01;82,65;44973
1216;15;14;93,33;1;0:00:12;0:03:14;0:01:48;86,67;44973
1217;230;228;99,13;2;0:00:07;0:02:47;0:01:01;93,89;44973
1218;232;224;96,55;8;0:00:12;0:02:51;0:01:34;86,46;44973
1219;237;231;97,47;6;0:00:11;0:03:01;0:01:59;87,71;44973
1220;42;39;92,86;3;0:00:17;0:02:51;0:01:40;78,57;44973
1221;215;211;98,14;4;0:00:06;0:03:06;0:02:54;94,81;44973
1222;153;152;99,35;1;0:00:04;0:02:35;0:00:55;98,69;44973
1223;39;39;100;0;0:00:14;0:03:42;0:01:37;84,62;44974
1224;334;322;96,41;12;0:00:17;0:02:56;0:02:18;77,13;44974
1225;236;225;95,34;11;0:00:13;0:02:53;0:01:56;85,09;44974
1226;186;182;97,85;4;0:00:08;0:02:38;0:02:10;95,11;44974
1227;202;197;97,52;5;0:00:13;0:02:33;0:01:56;87;44974
1228;185;182;98,38;3;0:00:08;0:02:49;0:02:33;90,27;44974
1229;38;38;100;0;0:00:04;0:03:26;0:00:57;97,37;44974
1230;25;24;96;1;0:00:03;0:02:44;0:00:46;96;44974
1231;203;195;96,06;8;0:00:08;0:02:38;0:08:34;88,56;44974
1232;296;292;98,65;4;0:00:04;0:02:40;0:00:58;98,63;44974
1233;233;223;95,71;10;0:00:09;0:02:47;0:01:46;87,83;44974
1234;198;194;97,98;4;0:00:08;0:02:42;0:01:43;91,79;44974
1235;181;179;98,9;2;0:00:04;0:02:39;0:00:48;99,44;44974
1236;166;162;97,59;4;0:00:06;0:02:39;0:01:01;93,87;44974
1237;19;19;100;0;0:00:03;0:02:27;0:00:03;100;44974
1238;196;181;92,35;15;0:00:14;0:02:37;0:02:36;78,13;44974
1239;176;172;97,73;4;0:00:16;0:02:30;0:02:56;79,43;44974
1240;221;209;94,57;12;0:00:12;0:02:42;0:02:50;83,87;44974
1241;196;191;97,45;5;0:00:14;0:02:51;0:05:54;86,01;44974
1242;211;202;95,73;9;0:00:15;0:02:46;0:02:54;79,33;44974
1243;201;194;96,52;7;0:00:16;0:02:49;0:03:28;81,41;44974
1244;23;22;95,65;1;0:00:10;0:03:02;0:01:02;82,61;44974
1245;225;210;93,33;15;0:00:10;0:02:37;0:03:37;85,91;44974
1246;202;195;96,53;7;0:00:11;0:02:47;0:01:52;86,8;44974
1247;191;184;96,34;7;0:00:07;0:02:50;0:01:56;92,55;44974
1248;212;209;98,58;3;0:00:10;0:02:51;0:01:45;89,1;44974
1249;210;203;96,67;7;0:00:12;0:03:22;0:03:52;85,24;44975
1250;167;159;95,21;8;0:00:16;0:03:16;0:02:42;83,03;44975
1251;12;11;91,67;1;0:00:03;0:02:12;0:00:58;91,67;44975
